都道府県名,二次医療圏番号,二次医療圏名,回答,男40～44歳,男45～49歳,男50～54歳,男55～59歳,男60～64歳,男65～69歳,男70～74歳,男中計,女40～44歳,女45～49歳,女50～54歳,女55～59歳,女60～64歳,女65～69歳,女70～74歳,女中計
北海道,0101,南渡島,毎日,1347,1815,1850,1864,1736,1597,1592,11801,563,833,798,688,584,488,386,4340
北海道,0101,南渡島,時々,1576,1877,1640,1423,1304,1026,1107,9953,1147,1522,1482,1272,1116,985,1114,8638
北海道,0101,南渡島,ほとんど飲まない（飲めない）,1594,2053,1697,1408,1217,1162,1453,10584,1798,2238,2332,2181,2180,2556,3660,16945
北海道,0102,南檜山,毎日,75,115,135,133,153,121,111,843,47,40,41,52,31,26,22,259
北海道,0102,南檜山,時々,110,136,103,102,83,64,77,675,73,89,72,69,62,64,62,491
北海道,0102,南檜山,ほとんど飲まない（飲めない）,90,99,97,69,63,80,88,586,86,113,137,122,163,178,281,1080
北海道,0103,北渡島檜山,毎日,112,130,152,144,137,128,129,932,30,60,55,44,38,22,25,274
北海道,0103,北渡島檜山,時々,150,176,124,128,103,80,100,861,102,98,96,81,71,79,66,593
北海道,0103,北渡島檜山,ほとんど飲まない（飲めない）,137,146,156,121,116,139,133,948,120,168,148,189,194,251,332,1402
北海道,0104,札幌,毎日,10361,14250,14719,14072,12524,7937,4518,78381,4847,6733,6270,5240,3490,1613,824,29017
北海道,0104,札幌,時々,14076,15766,14241,11904,9691,5445,2942,74065,10598,12199,11464,9142,6395,3032,1841,54671
北海道,0104,札幌,ほとんど飲まない（飲めない）,13285,15043,13675,10946,9368,5693,3811,71821,14269,16566,16052,13874,10579,6798,5448,83586
北海道,0105,後志,毎日,710,1077,1076,1094,998,964,925,6844,331,478,428,378,302,265,276,2458
北海道,0105,後志,時々,879,1047,934,864,727,618,575,5644,579,757,781,713,597,548,636,4611
北海道,0105,後志,ほとんど飲まない（飲めない）,940,1158,1092,896,778,718,877,6459,873,1205,1160,1128,1171,1301,1890,8728
北海道,0106,南空知,毎日,475,735,733,865,885,790,699,5182,186,343,351,331,259,172,182,1824
北海道,0106,南空知,時々,630,873,705,642,644,485,452,4431,443,610,597,494,531,378,403,3456
北海道,0106,南空知,ほとんど飲まない（飲めない）,656,846,711,684,649,638,646,4830,707,899,940,996,963,1074,1446,7025
北海道,0107,中空知,毎日,320,507,512,558,526,495,566,3484,167,227,219,206,187,175,142,1323
北海道,0107,中空知,時々,376,511,437,411,381,317,360,2793,339,400,369,390,365,293,377,2533
北海道,0107,中空知,ほとんど飲まない（飲めない）,379,539,503,469,453,414,551,3308,463,624,623,658,625,854,1317,5164
北海道,0108,北空知,毎日,87,103,113,149,145,136,147,880,48,51,59,54,39,30,35,316
北海道,0108,北空知,時々,97,138,120,135,126,123,123,862,81,105,113,101,95,95,89,679
北海道,0108,北空知,ほとんど飲まない（飲めない）,91,140,120,117,133,115,174,890,141,147,167,176,199,261,392,1483
北海道,0109,西胆振,毎日,603,1002,954,904,805,793,1000,6061,261,402,375,351,267,245,237,2138
北海道,0109,西胆振,時々,808,1007,881,693,641,543,606,5179,552,688,655,575,537,534,601,4142
北海道,0109,西胆振,ほとんど飲まない（飲めない）,766,1007,848,723,670,645,807,5466,790,1053,1092,986,972,1198,1990,8081
北海道,0110,東胆振,毎日,910,1364,1290,1176,1031,1030,1132,7933,308,492,399,370,278,260,212,2319
北海道,0110,東胆振,時々,1499,1747,1347,1154,992,820,793,8352,785,974,850,766,635,631,697,5338
北海道,0110,東胆振,ほとんど飲まない（飲めない）,1345,1554,1239,1072,852,811,968,7841,1249,1400,1332,1229,1179,1583,2342,10314
北海道,0111,日高,毎日,199,267,267,235,231,217,196,1612,97,103,109,84,69,48,46,556
北海道,0111,日高,時々,277,318,255,227,192,131,137,1537,163,207,179,152,148,130,119,1098
北海道,0111,日高,ほとんど飲まない（飲めない）,257,328,275,232,206,199,216,1713,242,335,329,327,305,362,484,2384
北海道,0112,上川中部,毎日,1321,1788,1736,1715,1553,1070,679,9862,558,756,762,579,450,183,109,3397
北海道,0112,上川中部,時々,1728,1950,1680,1385,1297,725,444,9209,1147,1427,1276,993,782,394,300,6319
北海道,0112,上川中部,ほとんど飲まない（飲めない）,1517,1939,1721,1381,1264,854,583,9259,1725,2059,2063,1700,1328,1001,1009,10885
北海道,0113,上川北部,毎日,174,272,274,278,333,259,266,1856,72,83,80,93,91,70,61,550
北海道,0113,上川北部,時々,261,295,265,262,236,184,255,1758,174,212,165,173,183,173,222,1302
北海道,0113,上川北部,ほとんど飲まない（飲めない）,221,291,276,264,218,226,265,1761,247,281,300,298,331,411,668,2536
北海道,0114,富良野,毎日,156,193,227,251,227,234,267,1555,55,92,88,84,73,63,61,516
北海道,0114,富良野,時々,176,222,186,193,192,142,148,1259,152,189,187,182,136,133,154,1133
北海道,0114,富良野,ほとんど飲まない（飲めない）,192,224,201,214,191,185,240,1447,259,293,307,268,328,382,587,2424
北海道,0115,留萌,毎日,139,197,215,215,200,203,164,1333,70,79,72,76,60,48,40,445
北海道,0115,留萌,時々,169,232,211,181,151,108,119,1171,113,157,139,120,126,101,145,901
北海道,0115,留萌,ほとんど飲まない（飲めない）,176,258,229,192,208,173,187,1423,175,250,280,260,287,344,463,2059
北海道,0116,宗谷,毎日,251,395,343,347,366,295,237,2234,117,140,122,116,78,68,39,680
北海道,0116,宗谷,時々,306,347,291,279,221,178,127,1749,189,199,178,156,138,119,114,1093
北海道,0116,宗谷,ほとんど飲まない（飲めない）,327,401,353,318,263,259,246,2167,329,359,355,342,346,343,456,2530
北海道,0117,北網,毎日,767,1055,1017,975,1028,741,787,6370,336,439,357,336,250,189,152,2059
北海道,0117,北網,時々,1032,1175,1018,915,792,568,555,6055,626,801,744,692,601,495,559,4518
北海道,0117,北網,ほとんど飲まない（飲めない）,982,1297,1087,1026,930,694,799,6815,1086,1328,1274,1352,1333,1344,1913,9630
北海道,0118,遠紋,毎日,223,337,340,340,320,254,303,2117,68,99,107,88,87,70,72,591
北海道,0118,遠紋,時々,273,307,285,280,211,161,167,1684,144,193,207,176,154,168,162,1204
北海道,0118,遠紋,ほとんど飲まない（飲めない）,264,337,328,308,284,247,307,2075,286,331,374,402,382,470,756,3001
北海道,0119,十勝,毎日,1231,1575,1608,1675,1640,1367,1384,10480,504,676,616,570,456,344,310,3476
北海道,0119,十勝,時々,1700,1998,1731,1527,1338,1035,1080,10409,1187,1418,1318,1137,1008,859,914,7841
北海道,0119,十勝,ほとんど飲まない（飲めない）,1714,2124,1824,1658,1562,1454,1645,11981,1822,2336,2381,2328,2216,2566,3533,17182
北海道,0120,釧路,毎日,890,1220,1249,1270,1267,1047,994,7937,371,567,524,452,375,287,205,2781
北海道,0120,釧路,時々,1097,1345,1128,933,839,683,701,6726,751,905,849,699,645,582,640,5071
北海道,0120,釧路,ほとんど飲まない（飲めない）,1141,1375,1291,1065,1014,869,1016,7771,1170,1476,1464,1395,1400,1707,2130,10742
北海道,0121,根室,毎日,257,343,312,299,312,231,195,1949,138,139,118,104,75,47,37,658
北海道,0121,根室,時々,355,391,314,308,227,182,172,1949,234,262,214,203,159,124,124,1320
北海道,0121,根室,ほとんど飲まない（飲めない）,340,381,318,303,257,245,260,2104,349,383,428,394,430,484,510,2978
青森県,0201,津軽地域,毎日,1429,1745,1891,1980,2023,1767,1793,12628,565,739,737,654,601,415,330,4041
青森県,0201,津軽地域,時々,1452,1553,1407,1253,1096,781,788,8330,1176,1389,1337,1334,1052,866,757,7911
青森県,0201,津軽地域,ほとんど飲まない（飲めない）,1114,1158,941,828,813,763,997,6614,1553,1749,1833,2151,2184,2545,3483,15498
青森県,0202,八戸地域,毎日,2006,2665,2932,2823,2711,2199,1886,17222,719,1024,1018,813,642,431,319,4966
青森県,0202,八戸地域,時々,1999,2246,2205,1940,1811,1236,1226,12663,1337,1783,1776,1571,1327,1032,868,9694
青森県,0202,八戸地域,ほとんど飲まない（飲めない）,1878,2198,1941,1526,1386,1260,1313,11502,2322,2773,2892,2711,2746,2990,3651,20085
青森県,0203,青森地域,毎日,1743,2304,2446,2537,2551,1963,1968,15512,706,1030,929,837,680,496,405,5083
青森県,0203,青森地域,時々,2011,2379,2086,1967,1660,1136,1185,12424,1487,1792,1633,1523,1307,1038,1131,9911
青森県,0203,青森地域,ほとんど飲まない（飲めない）,1625,1892,1597,1334,1222,1040,1387,10097,2236,2581,2462,2491,2471,2799,4082,19122
青森県,0204,西北五地域,毎日,434,645,710,777,712,785,803,4866,192,248,257,257,233,156,85,1428
青森県,0204,西北五地域,時々,439,525,495,486,385,335,305,2970,341,405,433,429,371,305,234,2518
青森県,0204,西北五地域,ほとんど飲まない（飲めない）,400,432,390,414,354,404,551,2945,570,705,839,915,1126,1503,1861,7519
青森県,0205,上十三地域,毎日,984,1270,1332,1281,1327,1210,1141,8545,396,562,514,417,339,272,178,2678
青森県,0205,上十三地域,時々,1085,1157,1083,912,850,654,618,6359,706,874,794,794,753,598,522,5041
青森県,0205,上十三地域,ほとんど飲まない（飲めない）,911,990,760,687,621,554,680,5203,1075,1247,1288,1190,1354,1638,2142,9934
青森県,0206,下北地域,毎日,279,425,426,464,483,418,390,2885,125,178,164,125,120,93,65,870
青森県,0206,下北地域,時々,322,355,315,332,302,231,217,2074,225,307,276,240,221,170,119,1558
青森県,0206,下北地域,ほとんど飲まない（飲めない）,316,342,315,246,254,273,301,2047,395,477,522,489,572,697,831,3983
岩手県,0301,盛岡,毎日,3473,4606,4424,4311,4299,3551,3641,28305,1433,1905,1711,1406,1160,938,815,9368
岩手県,0301,盛岡,時々,3092,3259,3006,2604,2325,1781,1889,17956,2345,2789,2563,2188,2091,1926,1941,15843
岩手県,0301,盛岡,ほとんど飲まない（飲めない）,3028,3264,2917,2311,2017,1724,2080,17341,3660,4207,4110,3985,4050,4674,6353,31039
岩手県,0302,岩手中部,毎日,1666,2233,1979,2011,1945,1903,1898,13635,596,801,703,590,541,439,344,4014
岩手県,0302,岩手中部,時々,1318,1395,1198,1080,930,735,778,7434,845,1034,976,865,805,755,734,6014
岩手県,0302,岩手中部,ほとんど飲まない（飲めない）,1649,1546,1340,1210,950,872,972,8539,1755,2008,1900,1924,1933,2447,3235,15202
岩手県,0303,胆江,毎日,1045,1250,1104,1156,1294,1356,1276,8481,337,411,335,334,309,259,235,2220
岩手県,0303,胆江,時々,731,837,637,605,572,489,532,4403,568,584,543,471,510,590,641,3907
岩手県,0303,胆江,ほとんど飲まない（飲めない）,886,987,816,735,648,587,689,5348,1044,1244,1130,1227,1377,1619,2109,9750
岩手県,0304,両磐,毎日,711,865,848,971,1037,1059,1017,6508,235,299,267,219,233,188,135,1576
岩手県,0304,両磐,時々,587,645,578,564,526,419,434,3753,388,480,424,425,416,368,314,2815
岩手県,0304,両磐,ほとんど飲まない（飲めない）,863,914,740,669,653,620,738,5197,959,1076,1086,1186,1276,1540,1796,8919
岩手県,0305,気仙,毎日,266,399,472,548,473,473,463,3094,85,126,110,88,69,49,44,571
岩手県,0305,気仙,時々,192,271,287,227,198,171,188,1534,158,183,205,180,167,145,99,1137
岩手県,0305,気仙,ほとんど飲まない（飲めない）,371,458,397,383,323,294,377,2603,435,569,613,713,673,883,1113,4999
岩手県,0306,釜石,毎日,215,303,339,317,287,311,291,2063,76,105,105,83,75,48,46,538
岩手県,0306,釜石,時々,163,195,189,179,136,130,127,1119,112,112,113,117,99,93,95,741
岩手県,0306,釜石,ほとんど飲まない（飲めない）,254,280,255,255,218,196,216,1674,279,344,351,373,412,472,684,2915
岩手県,0307,宮古,毎日,393,494,603,611,593,542,590,3826,138,181,166,107,104,87,64,847
岩手県,0307,宮古,時々,292,306,354,325,267,263,350,2157,172,245,230,229,215,213,211,1515
岩手県,0307,宮古,ほとんど飲まない（飲めない）,425,449,483,449,333,390,537,3066,485,586,679,653,807,1009,1419,5638
岩手県,0308,久慈,毎日,339,445,527,491,539,500,486,3327,114,188,191,110,84,48,49,784
岩手県,0308,久慈,時々,238,306,231,214,259,163,223,1634,186,200,225,196,216,164,137,1324
岩手県,0308,久慈,ほとんど飲まない（飲めない）,267,273,290,236,270,275,367,1978,382,434,521,512,658,851,1036,4394
岩手県,0309,二戸,毎日,302,417,448,464,497,552,491,3171,112,163,160,118,99,84,45,781
岩手県,0309,二戸,時々,243,244,243,261,254,244,259,1748,188,204,219,216,238,199,168,1432
岩手県,0309,二戸,ほとんど飲まない（飲めない）,278,315,320,326,292,322,379,2232,399,429,578,555,647,873,1107,4588
宮城県,0401,仙南,毎日,1021,1209,1180,1250,1412,1561,1585,9218,353,480,413,342,317,267,206,2378
宮城県,0401,仙南,時々,937,1021,839,734,741,744,764,5780,645,795,696,658,704,702,690,4890
宮城県,0401,仙南,ほとんど飲まない（飲めない）,1205,1242,1076,913,871,959,1144,7410,1331,1571,1496,1627,1783,2259,2594,12661
宮城県,0403,仙台,毎日,10390,13906,13739,12085,10984,9989,10462,81555,4426,6030,5342,4048,3464,2654,2509,28473
宮城県,0403,仙台,時々,11533,12697,11089,8929,7372,5634,5901,63155,8870,10296,9096,7343,6381,5681,6010,53677
宮城県,0403,仙台,ほとんど飲まない（飲めない）,11026,12254,10617,8071,6578,5994,7292,61832,13507,15173,14435,12722,12044,13722,18851,100454
宮城県,0406,大崎・栗原,毎日,1819,2144,1972,2145,2424,2444,2298,15246,610,812,669,571,524,422,262,3870
宮城県,0406,大崎・栗原,時々,1604,1553,1272,1244,1236,1089,1161,9159,1167,1227,1171,1165,1158,1106,962,7956
宮城県,0406,大崎・栗原,ほとんど飲まない（飲めない）,1835,1815,1475,1378,1382,1378,1466,10729,2126,2364,2243,2342,2775,3348,3738,18936
宮城県,0409,石巻・登米・気仙沼,毎日,2055,2473,2518,2593,2844,2883,2991,18357,686,893,760,677,633,475,348,4472
宮城県,0409,石巻・登米・気仙沼,時々,1728,1861,1581,1480,1398,1313,1528,10889,1319,1440,1436,1379,1346,1271,1251,9442
宮城県,0409,石巻・登米・気仙沼,ほとんど飲まない（飲めない）,2149,2301,2089,1828,1679,1777,2198,14021,2491,2915,3016,3379,3708,4484,5744,25737
秋田県,0501,大館・鹿角,毎日,486,639,627,687,758,713,747,4657,207,264,221,197,191,156,137,1373
秋田県,0501,大館・鹿角,時々,366,399,364,385,330,265,352,2461,296,354,356,345,329,309,364,2353
秋田県,0501,大館・鹿角,ほとんど飲まない（飲めない）,390,424,366,317,313,308,398,2516,547,541,579,612,740,949,1359,5327
秋田県,0502,北秋田,毎日,108,183,181,247,226,270,253,1468,32,52,51,51,54,60,40,340
秋田県,0502,北秋田,時々,90,118,95,91,81,87,126,688,71,86,90,74,81,95,82,579
秋田県,0502,北秋田,ほとんど飲まない（飲めない）,117,109,105,120,92,110,153,806,133,164,164,182,232,335,503,1713
秋田県,0503,能代・山本,毎日,405,536,551,636,718,700,703,4249,144,223,217,171,163,149,93,1160
秋田県,0503,能代・山本,時々,296,358,353,305,260,213,227,2012,246,325,326,313,337,288,273,2108
秋田県,0503,能代・山本,ほとんど飲まない（飲めない）,326,353,326,273,251,250,293,2072,477,527,614,643,712,850,1179,5002
秋田県,0504,秋田周辺,毎日,1745,2590,2590,2754,2743,2501,2754,17677,747,1012,908,746,744,661,597,5415
秋田県,0504,秋田周辺,時々,1963,2300,2105,1939,1503,1087,1163,12060,1377,1641,1653,1496,1310,1283,1408,10168
秋田県,0504,秋田周辺,ほとんど飲まない（飲めない）,1809,1917,1694,1376,1122,907,1220,10045,2337,2670,2649,2401,2554,3250,4681,20542
秋田県,0505,由利本荘・にかほ,毎日,439,581,536,621,658,820,862,4517,237,273,301,280,233,234,129,1687
秋田県,0505,由利本荘・にかほ,時々,481,434,447,380,389,335,345,2811,372,419,427,405,387,388,314,2712
秋田県,0505,由利本荘・にかほ,ほとんど飲まない（飲めない）,442,467,437,424,362,344,365,2841,516,579,581,617,754,1054,1264,5365
秋田県,0506,大仙・仙北,毎日,518,649,670,749,883,1046,1198,5713,186,260,227,207,221,251,190,1542
秋田県,0506,大仙・仙北,時々,443,484,436,422,428,324,390,2927,360,425,371,371,451,481,427,2886
秋田県,0506,大仙・仙北,ほとんど飲まない（飲めない）,445,465,390,335,315,371,527,2848,641,615,715,785,1014,1513,1862,7145
秋田県,0507,横手,毎日,493,583,586,709,738,819,952,4880,198,228,241,229,209,203,144,1452
秋田県,0507,横手,時々,373,398,330,297,291,235,218,2142,315,400,362,337,329,327,290,2360
秋田県,0507,横手,ほとんど飲まない（飲めない）,419,438,344,282,289,303,395,2470,610,683,700,713,858,1198,1347,6109
秋田県,0508,湯沢・雄勝,毎日,302,364,413,485,560,680,668,3472,99,153,158,120,124,143,98,895
秋田県,0508,湯沢・雄勝,時々,203,214,222,203,194,164,185,1385,180,183,229,200,239,228,211,1470
秋田県,0508,湯沢・雄勝,ほとんど飲まない（飲めない）,264,246,222,227,222,233,306,1720,282,369,392,446,554,766,939,3748
山形県,0601,村山,毎日,3698,4328,4260,4358,4754,4695,4757,30850,1460,1820,1449,1196,1187,840,577,8529
山形県,0601,村山,時々,4093,4221,3717,3329,3044,2677,2644,23725,3208,3487,3277,3007,2838,2366,1878,20061
山形県,0601,村山,ほとんど飲まない（飲めない）,3937,3970,3422,2849,2601,2461,2980,22220,5311,5624,5377,5506,5883,6732,7670,42103
山形県,0602,最上,毎日,521,686,611,752,896,857,846,5169,222,233,241,191,187,149,82,1305
山形県,0602,最上,時々,482,461,416,415,390,347,314,2825,380,414,408,430,426,363,273,2694
山形県,0602,最上,ほとんど飲まない（飲めない）,393,410,359,336,376,407,451,2732,555,683,719,784,1026,1159,1198,6124
山形県,0603,置賜,毎日,1541,1868,1768,1846,2038,1987,1921,12969,595,695,588,561,502,378,250,3569
山形県,0603,置賜,時々,1495,1572,1484,1340,1190,1069,1071,9221,1147,1249,1197,1135,985,916,702,7331
山形県,0603,置賜,ほとんど飲まない（飲めない）,1453,1527,1383,1217,1109,1039,1189,8917,1896,2156,2202,2250,2425,2713,3059,16701
山形県,0604,庄内,毎日,1959,2402,2451,2525,2867,2883,2766,17853,722,983,817,669,636,529,344,4700
山形県,0604,庄内,時々,1940,2084,1841,1719,1635,1420,1467,12106,1547,1725,1666,1633,1502,1341,1117,10531
山形県,0604,庄内,ほとんど飲まない（飲めない）,1734,1817,1606,1401,1292,1258,1560,10668,2552,2814,2914,3049,3424,4001,4938,23692
福島県,0701,県北,毎日,2803,3701,3819,3995,3977,3804,4141,26240,1033,1384,1289,1055,1008,798,730,7297
福島県,0701,県北,時々,3050,3329,2973,2633,2369,1925,2040,18319,2288,2611,2636,2358,2197,2035,1975,16100
福島県,0701,県北,ほとんど飲まない（飲めない）,3144,3591,3169,2611,2389,2176,2592,19672,3913,4579,4490,4426,4618,5303,6634,33963
福島県,0702,県中,毎日,3060,3776,3580,3579,3790,3492,3473,24750,1142,1500,1351,1102,1008,818,647,7568
福島県,0702,県中,時々,3179,3469,2922,2495,2275,1838,1824,18002,2458,2734,2536,2336,2121,1865,1952,16002
福島県,0702,県中,ほとんど飲まない（飲めない）,3241,3468,2934,2596,2356,2032,2354,18981,4048,4477,4192,4396,4634,5018,6039,32804
福島県,0703,県南,毎日,965,1192,1063,1249,1198,1302,1245,8214,343,402,349,277,271,254,180,2076
福島県,0703,県南,時々,924,918,771,739,699,559,544,5154,673,706,627,578,672,599,528,4383
福島県,0703,県南,ほとんど飲まない（飲めない）,1052,1050,894,798,762,725,833,6114,1203,1376,1216,1299,1588,1758,2038,10478
福島県,0706,相双,毎日,721,985,937,1017,1241,1360,1559,7820,229,337,295,280,314,284,238,1977
福島県,0706,相双,時々,713,828,718,610,602,673,763,4907,459,523,519,520,673,667,680,4041
福島県,0706,相双,ほとんど飲まない（飲めない）,834,892,773,702,665,877,992,5735,968,1062,1094,1188,1585,2180,2655,10732
福島県,0707,いわき,毎日,1763,2330,2410,2360,2321,1960,1836,14980,649,860,820,631,628,429,347,4364
福島県,0707,いわき,時々,1815,2071,1902,1576,1262,941,922,10489,1247,1504,1414,1288,1107,871,764,8195
福島県,0707,いわき,ほとんど飲まない（飲めない）,2115,2430,2120,1771,1467,1287,1377,12567,2366,2791,2674,2673,2679,2603,3305,19091
福島県,0708,会津・南会津,毎日,1507,1889,1826,2165,2337,2343,2359,14426,622,783,708,692,728,548,412,4493
福島県,0708,会津・南会津,時々,1435,1553,1324,1296,1190,1150,1175,9123,1087,1322,1257,1266,1281,1340,1274,8827
福島県,0708,会津・南会津,ほとんど飲まない（飲めない）,1521,1556,1448,1369,1343,1193,1475,9905,1886,2098,2203,2393,2559,3115,3740,17994
茨城県,0801,水戸,毎日,2466,3411,3506,3260,2919,2589,2347,20498,821,1144,1114,869,644,531,425,5548
茨城県,0801,水戸,時々,3190,3368,3055,2404,1970,1348,1174,16509,1967,2329,2152,1825,1359,1066,941,11639
茨城県,0801,水戸,ほとんど飲まない（飲めない）,3320,3945,3567,2764,2229,1850,1992,19667,3965,4675,4638,4194,3878,4093,4739,30182
茨城県,0802,日立,毎日,1102,1651,1896,1826,1679,1371,1413,10938,354,584,577,437,351,267,252,2822
茨城県,0802,日立,時々,1590,2099,2236,1787,1413,1066,1091,11282,878,1211,1215,938,826,665,687,6420
茨城県,0802,日立,ほとんど飲まない（飲めない）,1794,2147,2136,1679,1330,1171,1346,11603,1726,2255,2603,2263,2045,2201,2782,15875
茨城県,0803,常陸太田・ひたちなか,毎日,1722,2536,2761,2738,2469,2259,2247,16732,563,737,751,586,475,388,334,3834
茨城県,0803,常陸太田・ひたちなか,時々,2370,2669,2639,2155,1682,1218,1163,13896,1366,1740,1788,1323,1104,940,777,9038
茨城県,0803,常陸太田・ひたちなか,ほとんど飲まない（飲めない）,2659,3128,3091,2500,1961,1705,1887,16931,2900,3519,3786,3492,3396,3701,4503,25297
茨城県,0804,鹿行,毎日,1441,1988,2022,1721,1691,1628,1594,12085,480,645,627,448,360,308,269,3137
茨城県,0804,鹿行,時々,1708,1917,1568,1204,904,829,704,8834,1000,1210,1091,866,701,541,534,5943
茨城県,0804,鹿行,ほとんど飲まない（飲めない）,1784,2035,1747,1414,1177,1223,1418,10798,2020,2332,2406,2174,2401,2769,3278,17380
茨城県,0805,土浦,毎日,1316,1857,1948,1754,1569,1555,1467,11466,477,669,670,481,384,282,292,3255
茨城県,0805,土浦,時々,1524,1758,1641,1319,1010,810,791,8853,955,1227,1092,983,791,633,660,6341
茨城県,0805,土浦,ほとんど飲まない（飲めない）,1959,2240,1957,1559,1139,1053,1216,11123,1873,2459,2457,2143,2157,2306,2954,16349
茨城県,0806,つくば,毎日,2177,2694,2602,2158,1939,1612,1740,14922,778,1103,882,659,504,359,324,4609
茨城県,0806,つくば,時々,2807,2706,2260,1733,1286,867,795,12454,1827,2064,1769,1314,993,687,620,9274
茨城県,0806,つくば,ほとんど飲まない（飲めない）,2956,3121,2471,1874,1384,1121,1317,14244,3438,3672,3214,2678,2347,2584,3127,21060
茨城県,0807,取手・竜ヶ崎,毎日,2258,3379,3442,3005,2692,2761,3296,20833,852,1269,1157,930,799,748,646,6401
茨城県,0807,取手・竜ヶ崎,時々,2909,3466,3002,2413,1869,1537,1752,16948,1983,2489,2225,1796,1514,1413,1569,12989
茨城県,0807,取手・竜ヶ崎,ほとんど飲まない（飲めない）,3208,3766,3368,2537,1956,1768,2284,18887,3488,4164,4153,3690,3515,4064,5646,28720
茨城県,0808,筑西・下妻,毎日,1366,1858,1869,1833,1810,1824,1707,12267,452,622,609,452,360,333,267,3095
茨城県,0808,筑西・下妻,時々,1332,1485,1271,916,878,750,600,7232,848,1025,1034,866,721,578,435,5507
茨城県,0808,筑西・下妻,ほとんど飲まない（飲めない）,1761,1924,1615,1333,1191,1183,1110,10117,1997,2411,2390,2305,2448,2875,3034,17460
茨城県,0809,古河・坂東,毎日,1227,1580,1741,1525,1548,1431,1513,10565,402,594,579,471,372,289,251,2958
茨城県,0809,古河・坂東,時々,1147,1300,1165,832,719,531,556,6250,741,935,872,679,619,521,429,4796
茨城県,0809,古河・坂東,ほとんど飲まない（飲めない）,1580,1722,1611,1271,1100,968,1073,9325,1545,1972,2029,1739,1899,2258,2715,14157
栃木県,0901,県北,毎日,2219,2734,2668,2732,2748,2741,2638,18480,647,943,875,659,598,485,384,4591
栃木県,0901,県北,時々,2350,2503,2160,1669,1600,1457,1539,13278,1372,1621,1410,1223,1231,1054,896,8807
栃木県,0901,県北,ほとんど飲まない（飲めない）,3185,3365,2948,2237,2037,2083,2479,18334,3350,3785,3752,3533,3834,4670,5504,28428
栃木県,0902,県西,毎日,847,1234,1349,1261,1311,1215,1131,8348,291,453,397,314,289,261,235,2240
栃木県,0902,県西,時々,924,1101,1050,849,758,651,678,6011,563,778,715,622,555,487,490,4210
栃木県,0902,県西,ほとんど飲まない（飲めない）,1227,1514,1337,1105,1004,901,1125,8213,1364,1632,1757,1662,1725,1993,2484,12617
栃木県,0903,宇都宮,毎日,3215,4171,4364,3785,3246,2317,2304,23402,1055,1456,1361,978,709,528,492,6579
栃木県,0903,宇都宮,時々,4379,4596,4031,3152,2196,1358,1306,21018,2498,3026,2650,2056,1446,1176,1107,13959
栃木県,0903,宇都宮,ほとんど飲まない（飲めない）,4719,5254,4600,3439,2422,1816,1928,24178,4870,5377,5173,4219,3656,3479,4537,31311
栃木県,0904,県東,毎日,901,1134,1076,1087,1166,1176,1129,7669,253,374,290,259,245,179,159,1759
栃木県,0904,県東,時々,1004,1066,804,713,629,605,644,5465,521,578,593,421,455,393,324,3285
栃木県,0904,県東,ほとんど飲まない（飲めない）,1335,1429,1217,976,870,959,1045,7831,1324,1549,1421,1430,1680,2150,2420,11974
栃木県,0905,県南,毎日,2372,3517,3460,3169,3137,3058,2864,21577,768,1106,1115,815,715,573,442,5534
栃木県,0905,県南,時々,2866,3411,2895,2389,1987,1579,1544,16671,1727,2122,2020,1569,1342,1141,1006,10927
栃木県,0905,県南,ほとんど飲まない（飲めない）,3880,4606,3843,2985,2501,2228,2618,22661,4161,4809,4871,4188,4362,4930,5944,33265
栃木県,0906,両毛,毎日,1246,1765,1857,1769,1591,1386,1491,11105,351,634,624,457,388,334,289,3077
栃木県,0906,両毛,時々,1397,1566,1437,1139,879,688,701,7807,731,971,969,825,658,570,677,5401
栃木県,0906,両毛,ほとんど飲まない（飲めない）,1968,2333,2174,1714,1368,1214,1423,12194,1925,2344,2371,2191,2104,2448,3184,16567
群馬県,1001,前橋,毎日,1689,2418,2638,2312,2285,2115,2236,15693,586,923,882,745,642,533,531,4842
群馬県,1001,前橋,時々,2131,2340,2070,1673,1309,1002,1085,11610,1282,1645,1518,1286,1064,974,1154,8923
群馬県,1001,前橋,ほとんど飲まない（飲めない）,2854,3247,2870,2334,1847,1674,1937,16763,2800,3459,3585,3305,2963,3503,4647,24262
群馬県,1002,渋川,毎日,582,717,811,677,854,796,810,5247,165,249,263,191,185,158,129,1340
群馬県,1002,渋川,時々,575,680,545,465,450,374,354,3443,374,427,458,358,315,312,336,2580
群馬県,1002,渋川,ほとんど飲まない（飲めない）,856,945,808,716,643,535,651,5154,904,1049,1067,951,1025,1201,1574,7771
群馬県,1003,伊勢崎,毎日,1369,1938,2030,1895,1670,1366,1535,11803,466,646,671,517,397,336,326,3359
群馬県,1003,伊勢崎,時々,1520,1657,1510,1152,905,650,603,7997,911,1120,1051,824,600,445,529,5480
群馬県,1003,伊勢崎,ほとんど飲まない（飲めない）,2054,2425,2166,1726,1418,1258,1585,12632,2178,2676,2742,2282,2169,2659,3738,18444
群馬県,1004,高崎・安中,毎日,2171,3151,3529,3084,2568,2353,2457,19313,699,1169,1120,908,679,534,591,5700
群馬県,1004,高崎・安中,時々,2707,3135,2891,2236,1724,1211,1263,15167,1666,2128,2114,1600,1294,1035,1128,10965
群馬県,1004,高崎・安中,ほとんど飲まない（飲めない）,3165,3836,3460,2684,2125,1836,2329,19435,3329,4265,4337,3846,3322,4087,5749,28935
群馬県,1005,藤岡,毎日,308,459,482,461,435,456,527,3128,84,178,156,154,119,106,97,894
群馬県,1005,藤岡,時々,313,439,338,315,247,182,222,2056,223,238,264,230,202,203,189,1549
群馬県,1005,藤岡,ほとんど飲まない（飲めない）,451,565,523,399,357,300,442,3037,391,613,655,559,576,687,1089,4570
群馬県,1006,富岡,毎日,267,379,387,447,462,515,579,3036,91,137,103,110,91,83,91,706
群馬県,1006,富岡,時々,349,414,365,374,327,288,313,2430,222,290,293,255,242,256,217,1775
群馬県,1006,富岡,ほとんど飲まない（飲めない）,446,560,528,442,430,459,507,3372,478,681,728,708,767,971,1286,5619
群馬県,1007,吾妻,毎日,194,312,346,376,470,455,488,2641,74,99,122,98,96,92,74,655
群馬県,1007,吾妻,時々,237,296,263,233,213,212,234,1688,139,205,198,198,188,172,186,1286
群馬県,1007,吾妻,ほとんど飲まない（飲めない）,260,352,382,332,352,358,455,2491,315,422,496,515,590,668,951,3957
群馬県,1008,沼田,毎日,381,476,591,589,666,716,737,4156,122,217,204,165,195,163,127,1193
群馬県,1008,沼田,時々,313,426,372,405,314,298,324,2452,278,327,315,340,313,299,338,2210
群馬県,1008,沼田,ほとんど飲まない（飲めない）,430,534,522,432,461,501,589,3469,504,699,688,766,858,1073,1312,5900
群馬県,1009,桐生,毎日,742,1065,1221,1119,1017,945,1264,7373,250,445,437,347,316,285,344,2424
群馬県,1009,桐生,時々,791,940,891,683,558,408,491,4762,491,656,724,572,488,408,541,3880
群馬県,1009,桐生,ほとんど飲まない（飲めない）,1007,1305,1237,965,863,761,1096,7234,1051,1422,1546,1295,1306,1697,2565,10882
群馬県,1010,太田・館林,毎日,2147,2955,3002,2728,2211,1957,2493,17493,628,956,940,705,565,645,749,5188
群馬県,1010,太田・館林,時々,2859,2952,2807,2002,1297,1133,1452,14502,1422,1966,1713,1319,1147,1531,2271,11369
群馬県,1010,太田・館林,ほとんど飲まない（飲めない）,3330,3758,3172,2335,1780,1799,2401,18575,2847,3607,3520,2875,2726,3132,4439,23146
埼玉県,1101,南部,毎日,4849,6573,7096,5983,4508,3382,3636,36027,1807,2685,2686,2056,1516,1090,1156,12996
埼玉県,1101,南部,時々,5903,6336,5864,4277,2803,1829,1817,28829,4011,4492,4341,3281,2212,1538,1991,21866
埼玉県,1101,南部,ほとんど飲まない（飲めない）,5967,6642,6061,4289,2848,2242,2837,30886,5783,6955,6833,5540,4313,4140,6627,40191
埼玉県,1102,南西部,毎日,4219,5775,6244,5384,3910,3329,4108,32969,1702,2418,2401,1876,1313,1064,1301,12075
埼玉県,1102,南西部,時々,5494,5748,5439,4023,2677,1896,2066,27343,3853,4575,4451,3325,2247,1878,2450,22779
埼玉県,1102,南西部,ほとんど飲まない（飲めない）,5414,6332,5699,4282,2877,2198,3039,29841,5752,6717,6785,5533,4143,4461,7665,41056
埼玉県,1103,東部,毎日,5832,8393,9068,7603,6053,5341,7093,49383,2294,3431,3604,2743,2136,1886,2162,18256
埼玉県,1103,東部,時々,7000,8238,7527,5398,3668,2810,3374,38015,4849,6045,5902,4326,3231,2974,4095,31422
埼玉県,1103,東部,ほとんど飲まない（飲めない）,8175,10010,8840,6031,4159,3731,5311,46257,8776,10687,10499,8215,6696,8184,14192,67249
埼玉県,1104,さいたま,毎日,7621,10474,11183,9915,7985,5655,6054,58887,2833,3959,3933,3154,2281,1554,1642,19356
埼玉県,1104,さいたま,時々,10308,11028,10496,7965,5720,3679,3662,52858,6784,7814,7858,6161,4273,3047,3216,39153
埼玉県,1104,さいたま,ほとんど飲まない（飲めない）,9879,11046,10089,7460,5327,4110,5289,53200,10460,11978,12044,9801,7759,7847,12045,71934
埼玉県,1105,県央,毎日,2683,3943,4291,3889,3336,3144,3801,25087,964,1521,1554,1210,966,882,954,8051
埼玉県,1105,県央,時々,3255,3855,3706,2711,2103,1537,1892,19059,2022,2605,2622,2078,1586,1456,1952,14321
埼玉県,1105,県央,ほとんど飲まない（飲めない）,4025,4871,4490,3274,2412,2143,2937,24152,3805,4884,5223,4214,3732,4616,7767,34241
埼玉県,1106,川越比企,毎日,4039,5671,6070,5248,4873,4342,5282,35525,1364,2089,1988,1608,1384,1262,1259,10954
埼玉県,1106,川越比企,時々,4923,5735,5246,3892,3015,2448,2844,28103,3121,3824,3745,2870,2494,2262,2708,21024
埼玉県,1106,川越比企,ほとんど飲まない（飲めない）,6067,7243,6449,4784,3584,3196,4237,35560,5605,6902,7029,5937,5516,6485,9977,47451
埼玉県,1107,西部,毎日,3687,5203,5915,5232,4857,4116,4959,33969,1433,2149,2131,1797,1428,1200,1254,11392
埼玉県,1107,西部,時々,4394,5400,5139,4239,3060,2360,2597,27189,3120,3720,3698,3034,2427,2148,2474,20621
埼玉県,1107,西部,ほとんど飲まない（飲めない）,5286,6712,6163,4594,3431,2901,3657,32744,5515,6827,7005,5908,5108,5578,8455,44396
埼玉県,1108,利根,毎日,2831,4162,4422,3864,3877,3806,4431,27393,921,1356,1434,1176,1090,1005,1034,8016
埼玉県,1108,利根,時々,3255,3951,3550,2768,2301,1946,2154,19925,2089,2569,2449,2127,1755,1774,2051,14814
埼玉県,1108,利根,ほとんど飲まない（飲めない）,4533,5462,4722,3533,2986,2818,3525,27579,4342,5413,5312,4698,4722,5843,8829,39159
埼玉県,1109,北部,毎日,2494,3530,3736,3422,3241,3010,3034,22467,868,1272,1277,1061,908,712,590,6688
埼玉県,1109,北部,時々,2841,3086,2857,2319,1858,1465,1376,15802,1766,2193,2087,1756,1429,1205,1170,11606
埼玉県,1109,北部,ほとんど飲まない（飲めない）,3880,4311,3896,2976,2419,2137,2405,22024,3820,4694,4734,4232,4079,4343,5488,31390
埼玉県,1110,秩父,毎日,382,540,666,674,680,694,716,4352,131,195,197,176,182,144,141,1166
埼玉県,1110,秩父,時々,422,435,464,393,401,383,343,2841,272,379,368,313,299,267,236,2134
埼玉県,1110,秩父,ほとんど飲まない（飲めない）,512,626,607,526,504,491,611,3877,545,736,795,820,859,1106,1347,6208
千葉県,1201,千葉,毎日,4986,7350,8407,7058,5604,4042,4748,42195,1821,2897,2877,2262,1600,1217,1325,13999
千葉県,1201,千葉,時々,6321,7731,7680,5836,3844,2492,2662,36566,4154,5472,5584,4086,2761,2189,2765,27011
千葉県,1201,千葉,ほとんど飲まない（飲めない）,6785,8265,7912,5563,3985,2785,3693,38988,7100,8605,9369,7276,5767,5702,9502,53321
千葉県,1202,東葛南部,毎日,9923,13475,15409,12876,9350,6306,6950,74289,3978,5674,5655,4218,2979,1979,1921,26404
千葉県,1202,東葛南部,時々,12975,14520,13878,10133,6462,3976,3765,65709,8823,10730,10475,7524,4749,3379,3843,49523
千葉県,1202,東葛南部,ほとんど飲まない（飲めない）,12996,15432,13883,9855,6294,4334,5189,67983,14158,16484,16602,12786,9311,8583,12690,90614
千葉県,1203,東葛北部,毎日,7490,10385,10810,9114,7587,6280,7408,59074,2912,4125,4029,3036,2511,2028,2239,20880
千葉県,1203,東葛北部,時々,10150,11181,10191,7717,5372,3893,4318,52822,7023,8364,7952,6182,4288,3721,4492,42022
千葉県,1203,東葛北部,ほとんど飲まない（飲めない）,9827,11177,10312,7164,4998,4060,5442,52980,10562,12124,11956,9741,7976,9013,14272,75644
千葉県,1204,印旛,毎日,3174,4530,4643,4038,3937,3916,4436,28674,1231,1701,1655,1253,1158,1055,923,8976
千葉県,1204,印旛,時々,4192,4690,4335,3389,2855,2500,2606,24567,2829,3530,3221,2629,2412,2193,2233,19047
千葉県,1204,印旛,ほとんど飲まない（飲めない）,4800,5338,4856,3506,2954,2827,3322,27603,5211,6109,5993,5150,5042,5794,7520,40819
千葉県,1205,香取海匝,毎日,909,1398,1535,1485,1565,1700,1823,10415,290,456,498,379,383,299,253,2558
千葉県,1205,香取海匝,時々,1112,1263,1214,1052,1091,922,1050,7704,697,785,854,797,786,770,727,5416
千葉県,1205,香取海匝,ほとんど飲まない（飲めない）,1374,1599,1536,1304,1259,1369,1875,10316,1489,1826,2089,2177,2678,3443,4478,18180
千葉県,1206,山武長生夷隅,毎日,1596,2323,2567,2482,2659,2747,3126,17500,561,837,921,764,713,571,498,4865
千葉県,1206,山武長生夷隅,時々,1842,2093,2032,1772,1570,1474,1541,12324,1173,1358,1401,1206,1211,1110,1062,8521
千葉県,1206,山武長生夷隅,ほとんど飲まない（飲めない）,2397,2966,2682,2264,2120,2150,2682,17261,2533,3199,3496,3501,3766,4508,5769,26772
千葉県,1207,安房,毎日,386,581,656,569,611,603,692,4098,156,270,248,185,175,155,113,1302
千葉県,1207,安房,時々,473,517,522,392,373,343,340,2960,283,384,368,274,236,263,269,2077
千葉県,1207,安房,ほとんど飲まない（飲めない）,489,641,646,547,499,435,514,3771,713,863,915,810,881,1036,1450,6668
千葉県,1208,君津,毎日,1619,2209,2237,1979,2084,2145,2459,14732,542,711,710,562,477,435,480,3917
千葉県,1208,君津,時々,1986,2228,2033,1552,1297,1182,1234,11512,1081,1376,1259,1052,841,834,1066,7509
千葉県,1208,君津,ほとんど飲まない（飲めない）,2126,2525,2223,1725,1442,1608,2158,13807,2197,2613,2731,2355,2432,3478,5029,20835
千葉県,1209,市原,毎日,1038,1598,1809,1491,1546,1680,1876,11038,396,576,604,476,407,367,396,3222
千葉県,1209,市原,時々,1374,1640,1442,1141,902,958,1019,8476,863,1117,1115,871,830,781,840,6417
千葉県,1209,市原,ほとんど飲まない（飲めない）,1562,1939,1723,1327,1056,1196,1419,10222,1722,2167,2135,1877,1948,2674,3629,16152
東京都,1301,区中央部,毎日,10501,13291,14039,12343,8439,4287,3589,66489,4678,5840,5461,3904,2580,1528,1572,25563
東京都,1301,区中央部,時々,14743,15021,13644,10449,6567,2803,2271,65498,10104,10550,9337,6478,3913,2387,2467,45236
東京都,1301,区中央部,ほとんど飲まない（飲めない）,12197,12847,11239,8612,5357,2873,2717,55842,12535,13100,12037,8923,6055,4263,5997,62910
東京都,1302,区南部,毎日,8200,10625,11670,9506,6922,4619,5143,56685,3847,5126,4915,3566,2535,1909,2078,23976
東京都,1302,区南部,時々,10805,11265,10655,7771,4887,2821,2907,51111,8559,9198,8291,5890,3794,2799,3354,41885
東京都,1302,区南部,ほとんど飲まない（飲めない）,9360,10069,9329,6811,4431,3001,3861,46862,10825,11832,11053,8290,6108,5834,9108,63050
東京都,1303,区西南部,毎日,8773,10362,10317,9279,6898,4739,5175,55543,5259,6494,6185,4612,3365,2376,2470,30761
東京都,1303,区西南部,時々,11608,11410,10180,8507,5433,3261,3049,53448,10854,11535,10199,7805,5099,3416,3817,52725
東京都,1303,区西南部,ほとんど飲まない（飲めない）,8650,9130,8297,6717,4796,3269,4296,45155,12522,13459,12874,10324,7874,7060,10802,74915
東京都,1304,区西部,毎日,8186,9631,9936,8776,6493,4712,5010,52744,4464,5620,5251,4196,3089,2163,2199,26982
東京都,1304,区西部,時々,11148,10656,9305,7341,5091,3200,3107,49848,9250,9619,8955,6852,4766,3381,3832,46655
東京都,1304,区西部,ほとんど飲まない（飲めない）,9226,9554,8339,6402,4403,3189,3975,45088,11650,12289,11595,9551,7401,6406,9659,68551
東京都,1305,区西北部,毎日,11394,14146,15224,13560,10923,8282,9201,82730,5436,7368,7225,5787,4526,3594,3694,37630
東京都,1305,区西北部,時々,15277,15458,13694,10544,7805,5186,5324,73288,11774,12841,12273,9770,7299,5570,6508,66035
東京都,1305,区西北部,ほとんど飲まない（飲めない）,14425,15004,13455,10401,7672,5944,7391,74292,16868,18640,18615,15676,13077,12442,18343,113661
東京都,1306,区東北部,毎日,7329,10150,10764,9259,7522,6142,7511,58677,3345,4868,4971,4168,3133,2583,2837,25905
東京都,1306,区東北部,時々,9013,9837,8831,6601,4780,3519,3853,46434,7006,8034,7810,6033,4562,3666,4439,41550
東京都,1306,区東北部,ほとんど飲まない（飲めない）,8858,10147,9497,7139,4985,4405,6229,51260,10111,11647,11994,10351,8361,8991,14554,76009
東京都,1307,区東部,毎日,9959,13791,15455,12608,8749,6521,7449,74532,4751,6488,6566,4683,3346,2731,3033,31598
東京都,1307,区東部,時々,12949,13914,12947,9682,5859,3692,3895,62938,9677,11033,10407,7266,4856,3816,4867,51922
東京都,1307,区東部,ほとんど飲まない（飲めない）,11842,13217,12544,8945,5891,4396,5824,62659,13218,14818,14946,11273,8387,8574,14104,85320
東京都,1308,西多摩,毎日,1712,2557,3112,2783,2419,2460,3251,18294,780,1084,1234,924,794,718,740,6274
東京都,1308,西多摩,時々,1967,2341,2396,1959,1507,1354,1661,13185,1374,1844,1881,1588,1259,1290,1690,10926
東京都,1308,西多摩,ほとんど飲まない（飲めない）,2634,3170,3280,2403,1879,1712,2618,17696,2637,3440,3794,3377,3169,3866,6405,26688
東京都,1309,南多摩,毎日,6576,9330,11159,9777,7739,6752,9019,60352,2833,4225,4327,3311,2703,2413,2783,22595
東京都,1309,南多摩,時々,9252,10924,10852,9128,6230,4585,5555,56526,6625,8125,8481,6855,5146,4455,5749,45436
東京都,1309,南多摩,ほとんど飲まない（飲めない）,10521,12303,12418,9134,6233,5239,7634,63482,11373,13961,14744,12116,10062,11445,19099,92800
東京都,1310,北多摩西部,毎日,3329,4445,5006,4705,3732,3115,3934,28266,1383,1933,2009,1639,1273,1111,1234,10582
東京都,1310,北多摩西部,時々,4407,5002,4641,3996,2790,1884,2158,24878,3022,3465,3578,3003,2152,1842,2365,19427
東京都,1310,北多摩西部,ほとんど飲まない（飲めない）,4908,5551,5382,4253,2937,2342,3185,28558,5144,6082,6285,5316,4397,4734,7928,39886
東京都,1311,北多摩南部,毎日,6186,7528,8368,7772,5891,4634,5665,46044,2822,3816,3827,3031,2436,1889,2060,19881
東京都,1311,北多摩南部,時々,8443,8604,8371,6868,4659,3130,3370,43445,6665,7392,7219,5668,4011,3178,3770,37903
東京都,1311,北多摩南部,ほとんど飲まない（飲めない）,7735,8267,7758,6317,4292,3300,4677,42346,9577,10326,10528,8831,7090,7136,11017,64505
東京都,1312,北多摩北部,毎日,3812,5137,5770,5356,4284,3733,4530,32622,1706,2366,2478,2165,1704,1389,1546,13354
東京都,1312,北多摩北部,時々,5097,5361,5315,4560,3290,2287,2541,28451,3618,4252,4463,3688,2766,2268,2833,23888
東京都,1312,北多摩北部,ほとんど飲まない（飲めない）,5189,5870,5536,4509,3359,2584,3655,30702,6164,6996,7397,6492,5518,5817,9118,47502
東京都,1313,島しょ,毎日,119,159,157,185,145,171,172,1108,59,80,96,69,56,51,52,463
東京都,1313,島しょ,時々,122,154,139,104,85,63,92,759,99,113,104,64,78,61,77,596
東京都,1313,島しょ,ほとんど飲まない（飲めない）,129,131,140,105,90,115,143,853,187,178,166,132,175,235,293,1366
神奈川県,1404,川崎北部,毎日,5293,6701,7440,6757,4689,3131,3197,37208,2321,3093,3054,2400,1719,1096,989,14672
神奈川県,1404,川崎北部,時々,6943,7262,7263,5784,3494,2003,1813,34562,4952,5635,5668,4275,2770,1787,1847,26934
神奈川県,1404,川崎北部,ほとんど飲まない（飲めない）,6157,6964,6607,5017,3022,2009,2325,32101,7198,7953,8224,6430,4518,3714,5459,43496
神奈川県,1405,川崎南部,毎日,4679,6325,6192,5156,3638,2425,2158,30573,1915,2451,2338,1675,1085,710,619,10793
神奈川県,1405,川崎南部,時々,6472,6630,5824,4009,2588,1396,1192,28111,4300,4517,4030,2913,1794,1089,1110,19753
神奈川県,1405,川崎南部,ほとんど飲まない（飲めない）,5837,6400,5588,3862,2383,1523,1557,27150,6005,6229,5714,4280,3034,2491,3315,31068
神奈川県,1406,横須賀・三浦,毎日,2893,4715,5396,4911,4113,3194,3625,28847,1358,2045,2114,1600,1371,978,1013,10479
神奈川県,1406,横須賀・三浦,時々,3712,4616,4883,4089,3094,2046,2194,24634,2764,3685,3915,2944,2205,1838,2043,19394
神奈川県,1406,横須賀・三浦,ほとんど飲まない（飲めない）,3643,4950,4982,3918,2989,2219,2951,25652,4193,5563,6156,5218,4134,4355,6855,36474
神奈川県,1407,湘南東部,毎日,4013,5829,6313,5540,4259,3082,4041,33077,1820,2492,2359,1789,1345,1080,1309,12194
神奈川県,1407,湘南東部,時々,5267,5793,5832,4563,3017,1740,2115,28327,3546,4380,4202,3170,2194,1824,2505,21821
神奈川県,1407,湘南東部,ほとんど飲まない（飲めない）,4924,5899,5644,4386,2902,2110,3032,28897,5391,6402,6648,5380,4269,4456,8066,40612
神奈川県,1408,湘南西部,毎日,2486,3699,4028,3681,3209,2725,3401,23229,1042,1514,1474,1173,927,730,815,7675
神奈川県,1408,湘南西部,時々,3458,4035,3981,3393,2289,1682,2131,20969,2137,2773,2642,2210,1693,1429,1870,14754
神奈川県,1408,湘南西部,ほとんど飲まない（飲めない）,4025,4635,4579,3555,2591,2073,2923,24381,3852,4817,5073,4191,3603,4240,7023,32799
神奈川県,1409,県央,毎日,4123,6031,6810,5907,4667,3649,4638,35825,1518,2187,2314,1752,1344,1048,1301,11464
神奈川県,1409,県央,時々,6135,6940,6630,5245,3397,2223,2570,33140,3496,4459,4303,3253,2361,1955,2618,22445
神奈川県,1409,県央,ほとんど飲まない（飲めない）,6530,7719,7330,5380,3663,2496,3625,36743,5943,7672,7720,6129,4848,5274,9581,47167
神奈川県,1410,相模原,毎日,3421,4778,5415,4838,3845,2883,3261,28441,1289,1805,1936,1494,1120,805,815,9264
神奈川県,1410,相模原,時々,4719,5345,5212,4202,2820,1835,1963,26096,2937,3473,3485,2874,2008,1527,1817,18121
神奈川県,1410,相模原,ほとんど飲まない（飲めない）,5333,6291,5954,4412,2886,2029,2468,29373,5196,6429,6539,5353,4122,3866,6160,37665
神奈川県,1411,県西,毎日,1614,2336,2702,2587,2035,1567,1842,14683,503,794,838,633,529,428,446,4171
神奈川県,1411,県西,時々,2163,2425,2420,2071,1426,852,1051,12408,1209,1528,1556,1149,887,800,957,8086
神奈川県,1411,県西,ほとんど飲まない（飲めない）,2353,2860,2764,2243,1589,1152,1536,14497,2199,2770,2938,2488,2210,2363,3836,18804
神奈川県,1412,横浜,毎日,21083,29354,34119,30258,22762,15231,15396,168203,8706,12637,13177,10132,7257,4756,4479,61144
神奈川県,1412,横浜,時々,27924,31519,31604,25071,16364,9866,9066,151414,19518,23657,24195,18172,12093,8214,8679,114528
神奈川県,1412,横浜,ほとんど飲まない（飲めない）,26490,30915,30099,23088,15425,10140,11214,147371,28491,33731,35614,28631,21060,17631,24015,189173
新潟県,1501,下越,毎日,1438,1780,1956,1986,2078,2067,2322,13627,511,683,676,601,536,469,385,3861
新潟県,1501,下越,時々,1109,1170,1038,998,913,788,827,6843,797,961,919,816,865,849,837,6044
新潟県,1501,下越,ほとんど飲まない（飲めない）,1359,1478,1390,1141,896,903,1133,8300,1725,2061,2158,2070,2124,2601,3398,16137
新潟県,1502,新潟,毎日,6051,8606,8684,8127,7563,6611,6923,52565,2404,3402,3223,2742,2316,1994,1706,17787
新潟県,1502,新潟,時々,5880,6603,5692,4560,3685,2934,2998,32352,3957,4959,4537,3941,3376,3033,3365,27168
新潟県,1502,新潟,ほとんど飲まない（飲めない）,6883,7431,6244,4830,3688,3104,3762,35942,7770,9049,8289,7584,6936,7467,10777,57872
新潟県,1503,県央,毎日,1566,2056,2177,2092,1996,1857,1919,13663,544,866,763,638,586,474,369,4240
新潟県,1503,県央,時々,1371,1596,1353,1219,962,831,796,8128,960,1242,1188,1104,935,872,782,7083
新潟県,1503,県央,ほとんど飲まない（飲めない）,1552,1731,1628,1198,1060,888,962,9019,1835,2162,2250,2077,1913,2203,2743,15183
新潟県,1504,中越,毎日,2933,4003,4015,3831,3953,3519,3884,26138,1133,1580,1455,1131,1115,954,755,8123
新潟県,1504,中越,時々,2936,3211,2843,2479,2039,1628,1852,16988,2078,2582,2405,2141,1901,1766,1954,14827
新潟県,1504,中越,ほとんど飲まない（飲めない）,3579,3709,3240,2664,2123,1709,2089,19113,4140,4807,4521,4347,4130,4468,6226,32639
新潟県,1505,魚沼,毎日,1145,1541,1530,1542,1800,1975,2081,11614,519,695,607,574,526,543,363,3827
新潟県,1505,魚沼,時々,972,919,860,805,720,661,749,5686,788,840,861,777,821,861,825,5773
新潟県,1505,魚沼,ほとんど飲まない（飲めない）,995,1040,868,780,793,839,971,6286,1229,1396,1406,1382,1483,1873,2274,11043
新潟県,1506,上越,毎日,1953,2700,2706,2680,2831,2614,2873,18357,714,1059,870,779,696,627,493,5238
新潟県,1506,上越,時々,1891,2078,1793,1549,1295,1091,1164,10861,1388,1854,1656,1463,1327,1200,1270,10158
新潟県,1506,上越,ほとんど飲まない（飲めない）,1565,1647,1524,1301,1134,1080,1388,9639,1962,2302,2375,2292,2284,2720,3718,17653
新潟県,1507,佐渡,毎日,290,328,421,406,472,484,522,2923,84,148,115,110,125,95,94,771
新潟県,1507,佐渡,時々,305,332,304,310,318,267,333,2169,200,240,220,205,249,217,212,1543
新潟県,1507,佐渡,ほとんど飲まない（飲めない）,313,324,346,334,322,328,449,2416,430,444,497,517,608,719,982,4197
富山県,1601,新川,毎日,706,1156,1059,1024,1030,910,972,6857,264,442,385,325,269,202,227,2114
富山県,1601,新川,時々,769,842,835,658,506,361,384,4355,495,651,595,513,455,385,476,3570
富山県,1601,新川,ほとんど飲まない（飲めない）,882,1006,970,674,595,502,638,5267,1020,1316,1376,1297,1075,1302,2033,9419
富山県,1602,富山,毎日,3250,4924,5088,4417,3841,2999,3140,27659,1083,1782,1742,1344,1117,788,762,8618
富山県,1602,富山,時々,3429,3983,3460,2478,1919,1373,1365,18007,2269,2872,2661,2098,1628,1355,1517,14400
富山県,1602,富山,ほとんど飲まない（飲めない）,3967,4655,4143,3024,2227,1748,2028,21792,4609,5584,5413,4579,3912,3876,5449,33422
富山県,1603,高岡,毎日,1961,2939,2977,2597,2332,2258,2851,17915,602,937,872,672,608,504,557,4752
富山県,1603,高岡,時々,1733,2113,1881,1410,1090,897,1184,10308,1037,1490,1415,1092,939,901,1242,8116
富山県,1603,高岡,ほとんど飲まない（飲めない）,2513,3053,2506,1983,1531,1324,1985,14895,2666,3490,3571,3058,2943,3561,5967,25256
富山県,1604,砺波,毎日,693,1028,1007,967,1023,975,1330,7023,219,330,300,270,275,272,242,1908
富山県,1604,砺波,時々,685,763,671,555,508,447,616,4245,449,578,563,464,465,524,663,3706
富山県,1604,砺波,ほとんど飲まない（飲めない）,844,1070,847,712,628,573,839,5513,1080,1367,1319,1272,1328,1641,2471,10478
石川県,1701,南加賀,毎日,1131,1721,1725,1519,1387,1298,1641,10422,378,643,622,521,462,386,402,3414
石川県,1701,南加賀,時々,1262,1609,1268,1072,884,589,715,7399,841,1027,978,761,659,560,769,5595
石川県,1701,南加賀,ほとんど飲まない（飲めない）,1894,2370,1946,1518,1093,846,1250,10917,2152,2786,2679,2397,2054,2124,3260,17452
石川県,1702,石川中央,毎日,3765,5461,5542,4776,4455,3813,4725,32537,1467,2326,2142,1779,1472,1291,1413,11890
石川県,1702,石川中央,時々,5101,5993,5090,3995,3062,2106,2186,27533,3237,4102,3763,2966,2430,1919,2400,20817
石川県,1702,石川中央,ほとんど飲まない（飲めない）,5725,6659,5916,4190,3057,2481,3426,31454,6692,7999,7545,6180,5588,5916,9114,49034
石川県,1703,能登中部,毎日,451,671,685,646,684,798,1084,5019,153,228,221,199,199,197,191,1388
石川県,1703,能登中部,時々,492,605,559,501,432,357,424,3370,275,382,374,359,333,366,418,2507
石川県,1703,能登中部,ほとんど飲まない（飲めない）,706,905,735,633,568,550,814,4911,840,1199,1085,1093,1141,1519,2271,9148
石川県,1704,能登北部,毎日,214,353,363,431,504,574,717,3156,95,136,145,145,142,160,140,963
石川県,1704,能登北部,時々,175,258,231,216,205,171,261,1517,137,199,207,181,184,245,277,1430
石川県,1704,能登北部,ほとんど飲まない（飲めない）,251,292,259,263,260,316,457,2098,329,382,430,468,589,739,1259,4196
福井県,1801,福井・坂井,毎日,2056,2997,3062,2800,2677,2008,1970,17570,707,1077,1007,807,687,499,375,5159
福井県,1801,福井・坂井,時々,2547,2920,2636,2163,1723,1147,1055,14191,1769,2244,2057,1701,1357,943,948,11019
福井県,1801,福井・坂井,ほとんど飲まない（飲めない）,3242,3563,3087,2530,2016,1498,1529,17465,3579,4235,4314,3917,3452,3060,3565,26122
福井県,1802,奥越,毎日,311,391,408,438,491,413,387,2839,104,146,143,111,113,88,72,777
福井県,1802,奥越,時々,280,361,285,266,178,193,189,1752,241,261,239,250,237,206,183,1617
福井県,1802,奥越,ほとんど飲まない（飲めない）,410,414,355,277,301,301,300,2358,494,543,576,616,583,633,706,4151
福井県,1803,丹南,毎日,1050,1379,1373,1280,1145,833,779,7839,303,407,383,316,259,156,141,1965
福井県,1803,丹南,時々,1199,1379,1094,937,681,421,389,6100,751,892,869,689,490,346,363,4400
福井県,1803,丹南,ほとんど飲まない（飲めない）,1602,1705,1423,1094,854,629,675,7982,1744,1991,1933,1743,1592,1325,1617,11945
福井県,1804,嶺南,毎日,708,955,1045,979,1013,852,895,6447,209,301,264,220,217,169,135,1515
福井県,1804,嶺南,時々,803,891,742,705,599,402,351,4493,432,586,540,457,405,361,362,3143
福井県,1804,嶺南,ほとんど飲まない（飲めない）,881,939,857,727,629,574,622,5229,930,1205,1159,1135,1015,1192,1587,8223
山梨県,1901,中北,毎日,2350,3230,3643,3430,2956,2738,2655,21002,917,1339,1334,1075,867,672,503,6707
山梨県,1901,中北,時々,3236,3724,3332,2812,2178,1843,1801,18926,2041,2648,2461,2061,1697,1364,1227,13499
山梨県,1901,中北,ほとんど飲まない（飲めない）,3589,4077,3776,3131,2514,2270,2716,22073,4337,5318,5349,5044,4822,5295,6572,36737
山梨県,1902,峡東,毎日,622,947,1123,998,981,892,929,6492,232,382,426,359,259,193,145,1996
山梨県,1902,峡東,時々,784,926,879,711,587,530,554,4971,583,700,640,574,454,406,372,3729
山梨県,1902,峡東,ほとんど飲まない（飲めない）,940,1101,1066,905,817,758,915,6502,1191,1452,1639,1504,1515,1740,1965,11006
山梨県,1903,峡南,毎日,219,306,362,418,482,469,501,2757,60,130,112,92,98,66,54,612
山梨県,1903,峡南,時々,249,293,307,260,272,302,268,1951,162,218,221,235,240,187,163,1426
山梨県,1903,峡南,ほとんど飲まない（飲めない）,346,386,387,365,346,352,487,2669,411,517,612,669,680,890,1141,4920
山梨県,1904,富士・東部,毎日,788,1118,1346,1374,1380,1126,1124,8256,320,463,497,454,385,233,187,2539
山梨県,1904,富士・東部,時々,1037,1116,1155,1189,872,724,618,6711,657,807,891,807,710,526,428,4826
山梨県,1904,富士・東部,ほとんど飲まない（飲めない）,1112,1236,1376,1222,1030,953,1032,7961,1281,1556,1873,1906,1825,1959,2169,12569
長野県,2001,佐久,毎日,1078,1414,1514,1469,1520,1330,1512,9837,404,582,500,428,359,306,270,2849
長野県,2001,佐久,時々,1281,1374,1244,1103,978,757,837,7574,852,981,973,837,765,687,724,5819
長野県,2001,佐久,ほとんど飲まない（飲めない）,1534,1592,1501,1294,1058,1058,1186,9223,1789,1928,2078,2029,2014,2156,2736,14730
長野県,2002,上小,毎日,1060,1465,1512,1383,1243,1195,1229,9087,358,587,513,390,356,263,265,2732
長野県,2002,上小,時々,1132,1348,1193,1001,790,625,696,6785,742,970,968,797,719,613,614,5423
長野県,2002,上小,ほとんど飲まない（飲めない）,1244,1574,1389,1099,920,800,918,7944,1434,1748,1834,1761,1693,1792,2421,12683
長野県,2003,諏訪,毎日,797,1223,1338,1063,963,913,1143,7440,292,525,435,293,274,247,225,2291
長野県,2003,諏訪,時々,1237,1497,1343,1146,844,761,796,7624,776,1110,1019,824,679,542,669,5619
長野県,2003,諏訪,ほとんど飲まない（飲めない）,1423,1719,1658,1271,1022,842,1180,9115,1644,2138,2235,1899,1796,1865,2840,14417
長野県,2004,上伊那,毎日,972,1442,1510,1291,1370,1197,1456,9238,357,540,487,326,304,290,268,2572
長野県,2004,上伊那,時々,1207,1422,1205,1038,825,653,766,7116,788,1092,1010,840,739,683,731,5883
長野県,2004,上伊那,ほとんど飲まない（飲めない）,1450,1690,1477,1235,1031,881,1022,8786,1713,2049,2097,1953,1835,1911,2747,14305
長野県,2005,飯伊,毎日,874,1099,1182,1140,1188,1169,1163,7815,304,426,384,343,340,271,227,2295
長野県,2005,飯伊,時々,1010,1099,1080,950,670,591,517,5917,669,831,790,756,648,520,495,4709
長野県,2005,飯伊,ほとんど飲まない（飲めない）,1234,1395,1253,1068,839,810,877,7476,1437,1709,1708,1673,1676,1756,1906,11865
長野県,2006,木曽,毎日,136,203,205,266,241,288,388,1727,43,47,59,66,63,54,66,398
長野県,2006,木曽,時々,132,157,148,142,121,136,146,982,104,100,119,128,113,133,135,832
長野県,2006,木曽,ほとんど飲まない（飲めない）,129,166,177,182,135,164,204,1157,174,193,218,237,293,333,557,2005
長野県,2007,松本,毎日,2393,3430,3608,3211,2753,2604,2774,20773,869,1304,1264,1018,789,699,677,6620
長野県,2007,松本,時々,2745,3249,2921,2393,1682,1246,1397,15633,1764,2252,2151,1769,1520,1244,1576,12276
長野県,2007,松本,ほとんど飲まない（飲めない）,3424,3890,3665,2683,1968,1564,1877,19071,3470,4399,4495,3897,3455,3489,5011,28216
長野県,2008,大北,毎日,276,435,510,503,415,425,501,3065,101,204,185,156,133,100,109,988
長野県,2008,大北,時々,325,367,339,317,284,214,252,2098,218,298,277,281,249,212,227,1762
長野県,2008,大北,ほとんど飲まない（飲めない）,401,490,444,374,339,311,415,2774,415,552,614,615,566,574,836,4172
長野県,2009,長野,毎日,3264,4666,4813,4343,3893,3436,3929,28344,1115,1671,1626,1242,1023,799,759,8235
長野県,2009,長野,時々,3896,4352,4159,3335,2611,1938,2160,22451,2564,3324,3294,2679,2193,2034,2197,18285
長野県,2009,長野,ほとんど飲まない（飲めない）,3759,4385,4088,3261,2688,2208,2738,23127,4366,5603,5700,5354,4711,5198,7620,38552
長野県,2010,北信,毎日,535,679,761,768,783,769,897,5192,220,284,263,224,201,171,136,1499
長野県,2010,北信,時々,520,584,483,474,387,345,402,3195,361,456,445,467,454,404,396,2983
長野県,2010,北信,ほとんど飲まない（飲めない）,468,539,520,484,441,444,470,3366,702,885,851,924,901,967,1180,6410
岐阜県,2101,岐阜,毎日,3629,5122,5516,4918,4112,2973,3011,29281,1130,1794,1711,1399,1014,687,620,8355
岐阜県,2101,岐阜,時々,5042,5999,5452,3977,2870,1802,1602,26744,3165,4003,3867,2928,2017,1325,1294,18599
岐阜県,2101,岐阜,ほとんど飲まない（飲めない）,5832,6880,6207,4835,3561,2683,2968,32966,5757,7244,7561,6197,5283,4696,6186,42924
岐阜県,2102,西濃,毎日,1686,2439,2603,2376,2260,1975,2168,15507,453,727,663,590,540,403,402,3778
岐阜県,2102,西濃,時々,2125,2558,2272,1741,1359,1014,1104,12173,1229,1573,1483,1156,957,819,975,8192
岐阜県,2102,西濃,ほとんど飲まない（飲めない）,2965,3443,3083,2518,2081,1849,2237,18176,2875,3609,3721,3481,3371,3618,5021,25696
岐阜県,2103,中濃,毎日,1917,2678,2774,2565,2653,2420,2714,17721,532,813,812,722,701,594,500,4674
岐阜県,2103,中濃,時々,2396,2709,2270,1742,1450,1147,1221,12935,1467,1856,1782,1531,1272,1166,1153,10227
岐阜県,2103,中濃,ほとんど飲まない（飲めない）,2716,3159,2840,2223,1969,1868,2146,16921,2682,3314,3477,3272,3366,3574,4475,24160
岐阜県,2104,東濃,毎日,1783,2579,2843,2771,2592,2210,2350,17128,483,831,839,713,676,502,523,4567
岐阜県,2104,東濃,時々,1970,2315,2068,1689,1301,1037,974,11354,1280,1670,1628,1436,1255,1003,1096,9368
岐阜県,2104,東濃,ほとんど飲まない（飲めない）,2550,2938,2640,2233,1797,1630,1876,15664,2553,3112,3388,3217,3184,3256,4394,23104
岐阜県,2105,飛騨,毎日,850,1182,1195,1220,1143,760,632,6982,287,426,421,365,290,168,101,2058
岐阜県,2105,飛騨,時々,874,1008,934,725,606,315,257,4719,674,843,812,723,535,332,278,4197
岐阜県,2105,飛騨,ほとんど飲まない（飲めない）,823,992,915,749,559,393,413,4844,987,1300,1358,1279,1057,845,863,7689
静岡県,2201,賀茂,毎日,215,306,401,420,365,407,480,2594,84,141,133,113,113,120,94,798
静岡県,2201,賀茂,時々,211,269,301,212,189,160,147,1489,124,176,236,172,158,144,199,1209
静岡県,2201,賀茂,ほとんど飲まない（飲めない）,239,344,387,316,291,263,361,2201,279,410,439,435,448,596,894,3501
静岡県,2202,熱海伊東,毎日,263,482,612,612,616,588,924,4097,148,236,287,272,263,276,410,1892
静岡県,2202,熱海伊東,時々,302,434,452,382,364,307,421,2662,277,371,414,364,353,346,603,2728
静岡県,2202,熱海伊東,ほとんど飲まない（飲めない）,374,549,567,464,449,427,695,3525,425,617,761,708,737,943,1757,5948
静岡県,2203,駿東田方,毎日,2921,3927,4512,4086,3502,2732,2718,24398,973,1426,1381,1134,971,645,602,7132
静岡県,2203,駿東田方,時々,4440,5246,4841,4055,2975,1776,1534,24867,2630,3459,3232,2654,1920,1378,1304,16577
静岡県,2203,駿東田方,ほとんど飲まない（飲めない）,4850,5909,5558,4319,3251,2412,2609,28908,4850,6137,6480,5698,4775,4514,5835,38289
静岡県,2204,富士,毎日,2139,2991,3311,3001,2631,2125,2173,18371,611,959,986,736,607,431,399,4729
静岡県,2204,富士,時々,2706,2981,2741,2268,1626,1134,1171,14627,1568,1995,1998,1627,1269,988,999,10444
静岡県,2204,富士,ほとんど飲まない（飲めない）,3151,3636,3516,2698,2074,1674,1975,18724,2952,3746,3983,3673,3204,3346,4406,25310
静岡県,2205,静岡,毎日,3270,4759,5428,4809,4448,3708,4103,30525,1163,1696,1732,1348,1128,882,891,8840
静岡県,2205,静岡,時々,4807,5825,5456,4379,3473,2287,2248,28475,3179,3993,4012,3158,2520,1874,1905,20641
静岡県,2205,静岡,ほとんど飲まない（飲めない）,5151,6412,6230,4831,3617,2880,3493,32614,5800,7238,7721,6735,5793,5488,7343,46118
静岡県,2206,志太榛原,毎日,2408,3187,3447,3202,3208,2787,3137,21376,787,1070,1017,823,798,598,546,5639
静岡県,2206,志太榛原,時々,2830,3273,2980,2354,1927,1456,1458,16278,1969,2314,2278,1861,1604,1250,1380,12656
静岡県,2206,志太榛原,ほとんど飲まない（飲めない）,3758,4366,3796,3106,2566,2112,2592,22296,4078,5013,4900,4581,4451,4621,6243,33887
静岡県,2207,中東遠,毎日,2514,3198,3055,2896,3045,2557,2733,19998,643,918,776,644,633,447,416,4477
静岡県,2207,中東遠,時々,3805,4014,3398,2693,2261,1635,1575,19381,2042,2385,2050,1600,1470,1210,1071,11828
静岡県,2207,中東遠,ほとんど飲まない（飲めない）,4579,5059,4239,3417,2797,2304,2460,24855,4896,5576,5308,4746,4853,4825,5646,35850
静岡県,2208,西部,毎日,3742,5036,5512,5089,4637,3800,4071,31887,1156,1683,1665,1309,1097,842,693,8445
静岡県,2208,西部,時々,6888,7569,7283,5800,4596,3087,2864,38087,3856,4637,4474,3262,2659,1909,1839,22636
静岡県,2208,西部,ほとんど飲まない（飲めない）,8266,9453,8613,6962,5359,3885,4486,47024,8420,10272,10680,8991,8067,7466,9308,63204
愛知県,2302,海部,毎日,1372,2338,2693,2298,1828,1569,2001,14099,428,791,800,616,550,463,543,4191
愛知県,2302,海部,時々,1879,2344,2237,1486,1022,698,850,10516,1107,1471,1461,1030,762,714,1055,7600
愛知県,2302,海部,ほとんど飲まない（飲めない）,2673,3433,3168,2330,1623,1293,1834,16354,2347,3249,3272,2717,2351,2527,4529,20992
愛知県,2304,尾張東部,毎日,2456,3652,3972,3374,2831,2166,2840,21291,826,1280,1274,955,813,629,786,6563
愛知県,2304,尾張東部,時々,3855,4135,3869,2615,1824,1159,1272,18729,2196,2652,2558,1870,1346,1081,1448,13151
愛知県,2304,尾張東部,ほとんど飲まない（飲めない）,4252,4882,4506,3385,2300,1654,2423,23402,4435,5123,5146,4056,3312,3599,5793,31464
愛知県,2305,尾張西部,毎日,2204,3522,3944,3512,2890,2628,3407,22107,827,1256,1279,1068,926,778,936,7070
愛知県,2305,尾張西部,時々,3232,3887,3610,2695,1761,1327,1474,17986,2013,2772,2761,1920,1432,1262,1693,13853
愛知県,2305,尾張西部,ほとんど飲まない（飲めない）,4219,5340,4958,3870,2779,2319,3361,26846,4403,5725,5973,5193,4342,4791,7826,38253
愛知県,2306,尾張北部,毎日,3272,4946,5478,4687,3785,3212,3964,29344,984,1646,1662,1319,1089,877,1042,8619
愛知県,2306,尾張北部,時々,4588,5476,4922,3524,2423,1611,1855,24399,2640,3487,3399,2415,1694,1568,2034,17237
愛知県,2306,尾張北部,ほとんど飲まない（飲めない）,5885,7321,6766,4889,3247,2599,3464,34171,5653,7334,7384,5722,4653,5199,8416,44361
愛知県,2307,知多半島,毎日,3244,4623,5033,4551,3641,2969,3616,27677,921,1453,1408,1063,836,706,712,7099
愛知県,2307,知多半島,時々,4686,5505,4676,3710,2528,1866,2273,25244,2434,3038,2856,2197,1587,1332,1476,14920
愛知県,2307,知多半島,ほとんど飲まない（飲めない）,6274,7394,6441,4794,3575,2994,4322,35794,6243,7521,7442,6179,5568,6139,9937,49029
愛知県,2308,西三河北部,毎日,2879,3828,4277,3972,3255,2236,2685,23132,636,1061,1024,765,642,507,523,5158
愛知県,2308,西三河北部,時々,4737,4865,4554,3533,2355,1192,1208,22444,2177,2550,2443,1727,1252,948,1020,12117
愛知県,2308,西三河北部,ほとんど飲まない（飲めない）,4897,5433,5067,3631,2529,1703,2382,25642,4804,5786,5826,4468,3579,3793,5521,33777
愛知県,2309,西三河南部西,毎日,4038,5441,6047,5489,4146,2987,3398,31546,1013,1446,1550,1184,875,662,606,7336
愛知県,2309,西三河南部西,時々,5883,6433,5775,4452,2914,1665,1863,28985,2699,3299,3198,2255,1577,1215,1377,15620
愛知県,2309,西三河南部西,ほとんど飲まない（飲めない）,7741,8413,7763,5823,4070,2833,3714,40357,7054,8320,8248,7035,5308,5525,7577,49067
愛知県,2310,西三河南部東,毎日,2447,3321,3572,3176,2785,2338,2714,20353,707,999,950,798,675,546,571,5246
愛知県,2310,西三河南部東,時々,3791,3809,3377,2660,1917,1264,1449,18267,1968,2256,2154,1617,1335,1058,1102,11490
愛知県,2310,西三河南部東,ほとんど飲まない（飲めない）,4234,4698,4303,3259,2398,2045,2940,23877,4257,4934,4698,4114,3758,4271,6220,32252
愛知県,2311,東三河北部,毎日,213,335,335,356,385,405,487,2516,54,77,75,64,67,76,51,464
愛知県,2311,東三河北部,時々,321,337,300,229,219,199,243,1848,148,217,189,170,198,175,210,1307
愛知県,2311,東三河北部,ほとんど飲まない（飲めない）,402,398,381,348,320,305,437,2591,354,442,434,480,576,706,1044,4036
愛知県,2312,東三河南部,毎日,3231,4464,4863,4400,3927,3074,3407,27366,811,1284,1299,1020,919,726,731,6790
愛知県,2312,東三河南部,時々,4633,5156,4631,3605,2545,1710,1696,23976,2394,2978,2757,2202,1764,1387,1637,15119
愛知県,2312,東三河南部,ほとんど飲まない（飲めない）,5642,6520,6112,4556,3628,2725,3406,32589,5361,6540,6819,5928,5504,5505,7781,43438
愛知県,2313,名古屋・尾張中部,毎日,12789,17656,19350,16746,13362,9945,10635,100483,4512,6474,6807,5487,4258,3130,3213,33881
愛知県,2313,名古屋・尾張中部,時々,18824,19895,18426,13849,9386,5689,5427,91496,10884,12790,12231,9269,6541,4909,5298,61922
愛知県,2313,名古屋・尾張中部,ほとんど飲まない（飲めない）,20604,22594,20669,16060,11634,8016,9505,109082,20717,23571,23679,19569,15635,13788,19867,136826
三重県,2401,北勢,毎日,4461,6729,7350,6801,5753,4488,5563,41145,1312,2108,1987,1665,1381,1038,1024,10515
三重県,2401,北勢,時々,5598,6606,5966,4545,3058,2195,2446,30414,3564,4383,4269,3110,2295,2037,2231,21889
三重県,2401,北勢,ほとんど飲まない（飲めない）,7030,8497,8020,6188,4508,3743,5239,43225,6892,8875,9234,8049,7061,7950,12619,60680
三重県,2402,中勢伊賀,毎日,2140,2957,3211,2862,2955,2533,2973,19631,607,928,929,743,725,573,554,5059
三重県,2402,中勢伊賀,時々,2773,3061,2632,2162,1794,1370,1354,15146,1756,2087,1982,1686,1385,1182,1272,11350
三重県,2402,中勢伊賀,ほとんど飲まない（飲めない）,3414,3851,3567,2793,2396,2239,2743,21003,3643,4395,4468,4032,4148,4615,6545,31846
三重県,2403,南勢志摩,毎日,1910,2631,2903,2943,2719,2438,2905,18449,578,944,901,814,671,550,480,4938
三重県,2403,南勢志摩,時々,2410,2842,2470,2016,1580,1317,1434,14069,1515,1885,1850,1497,1225,1141,1203,10316
三重県,2403,南勢志摩,ほとんど飲まない（飲めない）,3037,3638,3466,2994,2692,2629,3575,22031,3416,4518,4684,4522,4657,5648,8136,35581
三重県,2404,東紀州,毎日,227,382,416,453,474,497,604,3053,73,118,134,137,145,126,125,858
三重県,2404,東紀州,時々,249,321,281,229,204,189,230,1703,155,203,194,182,191,183,239,1347
三重県,2404,東紀州,ほとんど飲まない（飲めない）,345,444,441,384,316,413,530,2873,375,477,547,591,671,864,1442,4967
滋賀県,2501,大津,毎日,1857,2544,2616,2551,2206,1842,2120,15736,732,1022,1025,852,783,533,572,5519
滋賀県,2501,大津,時々,2399,2701,2436,1872,1519,1040,1024,12991,1849,2094,2065,1639,1241,923,1100,10911
滋賀県,2501,大津,ほとんど飲まない（飲めない）,2640,3100,2768,2184,1702,1357,1645,15396,3442,4021,3965,3353,2946,2625,3646,23998
滋賀県,2502,湖南,毎日,2109,2809,2694,2321,1929,1566,1940,15368,693,1005,844,634,487,428,454,4545
滋賀県,2502,湖南,時々,2623,2756,2419,1727,1100,761,828,12214,1799,2065,1751,1221,866,792,951,9445
滋賀県,2502,湖南,ほとんど飲まない（飲めない）,3157,3476,2848,2163,1391,1178,1463,15676,3796,4262,3868,2866,2439,2455,3913,23599
滋賀県,2503,甲賀,毎日,766,1113,1146,1080,1076,1064,1175,7420,245,342,313,286,280,217,201,1884
滋賀県,2503,甲賀,時々,937,964,822,678,556,404,461,4822,539,615,540,473,484,431,525,3607
滋賀県,2503,甲賀,ほとんど飲まない（飲めない）,1329,1432,1301,964,846,663,916,7451,1320,1558,1481,1422,1490,1524,2114,10909
滋賀県,2504,東近江,毎日,1315,1616,1602,1579,1551,1405,1535,10603,361,481,451,416,336,320,256,2621
滋賀県,2504,東近江,時々,1497,1537,1264,981,837,594,627,7337,848,952,873,721,700,551,608,5253
滋賀県,2504,東近江,ほとんど飲まない（飲めない）,1924,2027,1729,1337,1118,904,1102,10141,2257,2488,2335,2244,2128,2146,2712,16310
滋賀県,2505,湖東,毎日,876,1203,1103,972,990,800,857,6801,273,356,328,232,232,154,143,1718
滋賀県,2505,湖東,時々,970,1023,853,637,519,371,337,4710,583,705,609,502,427,338,339,3503
滋賀県,2505,湖東,ほとんど飲まない（飲めない）,1277,1314,1176,904,722,587,595,6575,1377,1608,1599,1436,1368,1351,1591,10330
滋賀県,2506,湖北,毎日,894,1168,1162,1074,1069,901,963,7231,289,367,322,270,227,145,132,1752
滋賀県,2506,湖北,時々,939,1027,913,765,587,410,350,4991,591,716,666,555,470,391,324,3713
滋賀県,2506,湖北,ほとんど飲まない（飲めない）,1135,1288,1174,991,784,638,691,6701,1430,1606,1759,1696,1585,1531,1713,11320
滋賀県,2507,湖西,毎日,191,252,289,327,358,249,256,1922,61,84,95,92,84,55,42,513
滋賀県,2507,湖西,時々,200,227,250,202,208,139,123,1349,152,196,200,196,171,119,132,1166
滋賀県,2507,湖西,ほとんど飲まない（飲めない）,294,346,362,303,291,195,192,1983,382,448,502,539,497,412,507,3287
京都府,2601,丹後,毎日,525,757,813,826,851,743,835,5350,198,298,253,233,218,168,145,1513
京都府,2601,丹後,時々,424,590,548,451,367,327,354,3061,330,467,449,417,353,349,357,2722
京都府,2601,丹後,ほとんど飲まない（飲めない）,495,612,598,548,481,406,511,3651,613,883,1020,979,992,1001,1302,6790
京都府,2602,中丹,毎日,970,1418,1332,1277,1290,1188,1453,8928,344,524,476,395,391,288,300,2718
京都府,2602,中丹,時々,1007,1096,976,792,663,512,590,5636,639,817,731,642,593,454,639,4515
京都府,2602,中丹,ほとんど飲まない（飲めない）,1100,1391,1288,1024,863,706,922,7294,1228,1699,1751,1468,1550,1570,2539,11805
京都府,2603,南丹,毎日,651,822,902,872,896,887,1061,6091,218,326,307,287,279,241,197,1855
京都府,2603,南丹,時々,689,768,709,562,503,418,429,4078,449,575,573,502,482,354,467,3402
京都府,2603,南丹,ほとんど飲まない（飲めない）,865,1008,801,680,638,568,745,5305,970,1198,1236,1170,1230,1260,1785,8849
京都府,2604,京都・乙訓,毎日,6939,9687,10433,9176,8060,6026,6967,57288,3010,4321,4401,3700,2905,2189,2296,22822
京都府,2604,京都・乙訓,時々,9372,10425,9601,7536,5589,3485,3341,49349,6984,8024,7743,6025,4492,3157,3586,40011
京都府,2604,京都・乙訓,ほとんど飲まない（飲めない）,9690,11747,10872,8072,5980,4262,5312,55935,11692,13850,13429,11179,8597,7727,11351,77825
京都府,2605,山城北,毎日,1921,2970,3118,2680,2308,2222,3059,18278,723,1188,1119,931,793,778,986,6518
京都府,2605,山城北,時々,2386,3104,2612,1990,1494,1101,1386,14073,1685,2217,2051,1576,1298,1250,1680,11757
京都府,2605,山城北,ほとんど飲まない（飲めない）,3196,3979,3488,2484,1822,1550,2287,18806,3345,4280,4069,3437,2965,3453,6322,27871
京都府,2606,山城南,毎日,569,801,841,717,669,617,850,5064,197,274,235,216,170,166,209,1467
京都府,2606,山城南,時々,752,893,749,575,481,339,368,4157,481,624,572,437,351,365,428,3258
京都府,2606,山城南,ほとんど飲まない（飲めない）,947,1070,954,688,514,479,640,5292,1047,1246,1152,1014,895,960,1523,7837
大阪府,2701,豊能,毎日,5230,7115,7839,6576,5324,3871,4638,40593,2068,2983,3061,2344,1751,1529,1697,15433
大阪府,2701,豊能,時々,6754,7413,7023,5210,3451,2042,2314,34207,4651,5660,5598,4080,2834,2070,2572,27465
大阪府,2701,豊能,ほとんど飲まない（飲めない）,6523,7508,6908,5222,3568,2497,2910,35136,7858,9273,9415,7392,5357,4924,7279,51498
大阪府,2702,三島,毎日,3435,5054,5517,4505,3760,3092,3946,29309,1224,2047,2016,1537,1263,1055,1199,10341
大阪府,2702,三島,時々,4303,5111,4644,3195,2402,1583,1750,22988,3043,3645,3586,2500,1889,1632,2128,18423
大阪府,2702,三島,ほとんど飲まない（飲めない）,4955,6033,5516,3759,2668,2126,3043,28100,5773,7071,6870,5092,4365,4669,7658,41498
大阪府,2703,北河内,毎日,4541,6941,7705,6638,5375,4250,5093,40543,1777,2870,2995,2378,1760,1362,1638,14780
大阪府,2703,北河内,時々,5232,6358,5942,4559,3161,2071,2182,29505,3659,4704,4814,3627,2478,2142,2894,24318
大阪府,2703,北河内,ほとんど飲まない（飲めない）,6509,8262,7875,5615,3880,2871,3832,38844,7034,9171,9546,7407,5773,5905,10190,55026
大阪府,2704,中河内,毎日,3266,4963,5750,4926,4033,3073,3781,29792,1225,2083,2445,2085,1560,1192,1384,11974
大阪府,2704,中河内,時々,3527,4203,4026,3034,2064,1398,1526,19778,2449,3237,3296,2681,1934,1612,2108,17317
大阪府,2704,中河内,ほとんど飲まない（飲めない）,4577,5788,5620,4093,2833,2112,2971,27994,4644,6321,6709,5599,4549,4515,7292,39629
大阪府,2705,南河内,毎日,1967,3035,3596,3404,3119,2933,3778,21832,767,1290,1436,1223,1123,965,1175,7979
大阪府,2705,南河内,時々,2147,2613,2623,2126,1690,1357,1488,14044,1527,2073,2146,1884,1508,1460,2066,12664
大阪府,2705,南河内,ほとんど飲まない（飲めない）,2838,3644,3616,2955,2444,2122,3031,20650,3267,4292,4794,4212,3812,4593,7331,32301
大阪府,2706,堺市,毎日,3570,5406,5949,4899,3941,3206,4012,30983,1383,2222,2264,1823,1327,1094,1340,11453
大阪府,2706,堺市,時々,3706,4738,4428,3163,2106,1397,1539,21077,2750,3619,3447,2550,1750,1563,2119,17798
大阪府,2706,堺市,ほとんど飲まない（飲めない）,4802,6309,5639,3939,2872,2056,2855,28472,5602,6994,6813,5272,4232,4462,7465,40840
大阪府,2707,泉州,毎日,3595,5612,6364,5619,4715,3886,4721,34512,1375,2227,2518,2027,1540,1321,1360,12368
大阪府,2707,泉州,時々,3594,4490,4356,3177,2267,1692,1891,21467,2563,3436,3420,2623,2037,1825,2274,18178
大阪府,2707,泉州,ほとんど飲まない（飲めない）,4600,5920,5677,4282,3172,2720,3544,29915,5445,7256,7408,6179,5277,5933,8766,46264
大阪府,2708,大阪市,毎日,14644,19628,21661,18322,13929,9392,8715,106291,7379,9985,10329,8419,5844,3551,3211,48718
大阪府,2708,大阪市,時々,17056,18376,17117,12500,8226,4360,3797,81432,13635,15103,14354,11014,7013,4138,4292,69549
大阪府,2708,大阪市,ほとんど飲まない（飲めない）,18127,20370,19112,13806,9755,6221,6569,93960,21783,24629,24553,20197,14917,10672,14042,130793
兵庫県,2801,神戸,毎日,7472,10513,11545,10049,8935,7399,8394,64307,2900,4241,4267,3562,2980,2425,2530,22905
兵庫県,2801,神戸,時々,9517,11033,10204,8109,6224,4118,4095,53300,6884,8359,8167,6520,5010,3892,4327,43159
兵庫県,2801,神戸,ほとんど飲まない（飲めない）,9467,11346,10745,8115,6421,4883,6035,57012,11196,13549,13340,11369,10005,9518,14022,82999
兵庫県,2804,東播磨,毎日,3614,5040,5433,4512,4023,3354,3673,29649,1087,1575,1541,1258,968,802,796,8027
兵庫県,2804,東播磨,時々,4610,5061,4501,3340,2407,1677,1634,23230,2739,3356,3266,2340,1719,1402,1568,16390
兵庫県,2804,東播磨,ほとんど飲まない（飲めない）,4991,5584,5122,3824,2887,2181,2714,27303,5028,6139,6200,5020,4280,4559,6514,37740
兵庫県,2805,北播磨,毎日,1139,1727,1728,1655,1591,1550,1789,11179,329,522,448,439,359,322,254,2673
兵庫県,2805,北播磨,時々,1277,1423,1320,1102,848,650,679,7299,814,1023,953,771,679,587,650,5477
兵庫県,2805,北播磨,ほとんど飲まない（飲めない）,1638,1848,1744,1442,1156,990,1161,9979,1830,2271,2431,2254,2223,2318,3006,16333
兵庫県,2808,但馬,毎日,855,1199,1215,1252,1430,1324,1416,8691,228,372,360,293,283,242,184,1962
兵庫県,2808,但馬,時々,899,1043,882,719,722,644,717,5626,603,743,779,745,713,568,562,4713
兵庫県,2808,但馬,ほとんど飲まない（飲めない）,972,1113,1008,850,803,731,894,6371,1228,1606,1701,1685,1793,2022,2428,12463
兵庫県,2809,丹波,毎日,464,654,630,619,720,683,772,4542,112,182,147,143,176,137,94,991
兵庫県,2809,丹波,時々,509,546,472,402,443,298,286,2956,337,390,404,342,349,298,293,2413
兵庫県,2809,丹波,ほとんど飲まない（飲めない）,638,667,571,479,426,400,420,3601,712,834,869,895,948,944,1128,6330
兵庫県,2810,淡路,毎日,572,770,779,835,905,967,1025,5853,175,265,246,220,221,216,194,1537
兵庫県,2810,淡路,時々,542,594,521,453,414,322,372,3218,404,455,442,410,401,356,330,2798
兵庫県,2810,淡路,ほとんど飲まない（飲めない）,662,814,753,605,571,576,703,4684,992,1199,1172,1105,1344,1441,1857,9110
兵庫県,2811,阪神,毎日,8237,12044,13462,11866,9726,7657,8966,71958,3126,4803,5161,4061,3114,2445,2686,25396
兵庫県,2811,阪神,時々,9909,11910,11624,8744,6145,4029,4193,56554,7497,9404,9441,7118,5121,3916,4757,47254
兵庫県,2811,阪神,ほとんど飲まない（飲めない）,9717,12218,11854,9119,6387,4831,6443,60569,11875,15169,15573,12538,10082,9729,15098,90064
兵庫県,2812,播磨姫路,毎日,3887,5796,5777,5309,4802,4344,5080,34995,1085,1624,1662,1299,1163,911,914,8658
兵庫県,2812,播磨姫路,時々,4288,4991,4257,3424,2680,1958,2075,23673,2625,3363,3028,2463,1982,1838,2276,17575
兵庫県,2812,播磨姫路,ほとんど飲まない（飲めない）,5556,6349,5709,4633,3669,2994,4013,32923,5766,7652,7370,6691,6100,6975,10289,50843
奈良県,2901,奈良,毎日,1247,1959,2198,2130,1918,1659,2060,13171,561,832,935,802,619,547,614,4910
奈良県,2901,奈良,時々,1699,1969,1996,1577,1286,944,1071,10542,1305,1739,1763,1444,1083,1071,1294,9699
奈良県,2901,奈良,ほとんど飲まない（飲めない）,1951,2407,2304,1864,1484,1258,1712,12980,2574,3184,3412,2867,2544,2862,4399,21842
奈良県,2902,東和,毎日,637,982,1072,1057,1062,982,1149,6941,253,363,408,388,307,221,235,2175
奈良県,2902,東和,時々,793,894,870,692,571,451,518,4789,566,716,719,585,482,442,528,4038
奈良県,2902,東和,ほとんど飲まない（飲めない）,1087,1335,1252,1044,853,757,951,7279,1306,1525,1612,1506,1512,1610,2263,11334
奈良県,2903,西和,毎日,1397,1980,2155,1885,1753,1597,2249,13016,518,769,764,657,592,553,659,4512
奈良県,2903,西和,時々,1686,2009,1980,1525,1185,835,982,10202,1241,1624,1587,1233,963,958,1310,8916
奈良県,2903,西和,ほとんど飲まない（飲めない）,1991,2639,2369,1854,1362,1130,1633,12978,2517,3097,3081,2565,2272,2649,4425,20606
奈良県,2904,中和,毎日,1484,2103,2322,2199,1964,1689,2017,13778,591,772,861,752,612,503,506,4597
奈良県,2904,中和,時々,1771,2061,1844,1455,1124,820,898,9973,1246,1471,1681,1279,906,835,985,8403
奈良県,2904,中和,ほとんど飲まない（飲めない）,2213,2678,2594,1953,1524,1325,1652,13939,2632,3341,3347,2906,2628,2783,4111,21748
奈良県,2905,南和,毎日,173,252,382,371,430,436,406,2450,80,118,101,150,113,106,68,736
奈良県,2905,南和,時々,173,207,209,208,202,146,141,1286,148,184,174,202,189,149,167,1213
奈良県,2905,南和,ほとんど飲まない（飲めない）,265,337,307,323,348,294,329,2203,340,453,482,552,641,614,749,3831
和歌山県,3001,和歌山,毎日,1773,2593,2770,2689,2496,2133,2589,17043,556,850,921,870,649,647,695,5188
和歌山県,3001,和歌山,時々,1953,2244,2068,1586,1207,835,968,10861,1134,1485,1473,1167,952,854,1206,8271
和歌山県,3001,和歌山,ほとんど飲まない（飲めない）,2646,3250,2905,2245,1892,1580,2091,16609,2550,3220,3268,3006,2765,3196,5115,23120
和歌山県,3002,那賀,毎日,464,686,749,714,691,636,782,4722,172,257,281,244,235,189,171,1549
和歌山県,3002,那賀,時々,429,582,515,397,352,258,269,2802,266,390,416,389,289,299,355,2404
和歌山県,3002,那賀,ほとんど飲まない（飲めない）,697,805,753,641,563,500,566,4525,726,897,952,935,891,974,1341,6716
和歌山県,3003,橋本,毎日,274,435,474,478,526,572,631,3390,100,150,163,145,156,147,142,1003
和歌山県,3003,橋本,時々,313,362,305,282,283,205,232,1982,214,286,254,271,250,228,264,1767
和歌山県,3003,橋本,ほとんど飲まない（飲めない）,418,539,468,426,413,409,472,3145,488,650,717,659,753,824,1115,5206
和歌山県,3004,有田,毎日,291,452,460,473,478,431,541,3126,115,148,150,145,153,129,98,938
和歌山県,3004,有田,時々,286,313,278,213,198,167,158,1613,202,228,270,216,184,199,215,1514
和歌山県,3004,有田,ほとんど飲まない（飲めない）,383,449,394,332,264,292,358,2472,509,566,632,577,582,660,804,4330
和歌山県,3005,御坊,毎日,326,439,429,458,490,459,559,3160,129,143,152,135,144,140,125,968
和歌山県,3005,御坊,時々,332,366,291,235,194,168,136,1722,193,247,262,227,208,210,207,1554
和歌山県,3005,御坊,ほとんど飲まない（飲めない）,310,404,357,295,276,282,271,2195,393,493,474,488,488,611,687,3634
和歌山県,3006,田辺,毎日,594,880,889,888,936,786,835,5808,214,322,348,348,302,240,226,2000
和歌山県,3006,田辺,時々,469,598,477,416,357,285,250,2852,368,456,410,397,387,311,409,2738
和歌山県,3006,田辺,ほとんど飲まない（飲めない）,635,736,711,618,540,455,552,4247,874,986,1012,1064,966,1036,1275,7213
和歌山県,3007,新宮,毎日,193,330,366,361,401,394,468,2513,64,104,121,131,132,115,99,766
和歌山県,3007,新宮,時々,215,232,233,183,172,127,199,1361,144,171,193,168,184,171,204,1235
和歌山県,3007,新宮,ほとんど飲まない（飲めない）,264,374,342,320,271,226,372,2169,298,383,410,445,457,632,987,3612
鳥取県,3101,東部,毎日,1285,1700,1619,1609,1719,1588,1568,11088,474,551,514,440,416,362,269,3026
鳥取県,3101,東部,時々,1213,1329,1059,945,832,643,669,6690,745,954,817,738,695,605,581,5135
鳥取県,3101,東部,ほとんど飲まない（飲めない）,1728,1854,1462,1270,1072,966,1031,9383,2071,2352,2252,2117,2154,2384,2889,16219
鳥取県,3102,中部,毎日,520,656,650,651,716,698,714,4605,162,210,181,169,169,168,125,1184
鳥取県,3102,中部,時々,398,416,380,326,314,264,223,2321,241,360,265,268,268,274,242,1918
鳥取県,3102,中部,ほとんど飲まない（飲めない）,680,643,558,507,453,402,455,3698,794,955,880,857,926,995,1207,6614
鳥取県,3103,西部,毎日,1116,1511,1494,1468,1438,1301,1341,9669,383,571,479,410,395,319,310,2867
鳥取県,3103,西部,時々,1083,1234,1013,909,875,573,561,6248,755,909,812,685,636,535,609,4941
鳥取県,3103,西部,ほとんど飲まない（飲めない）,1664,1766,1586,1278,1082,958,1057,9391,1944,2199,2146,2040,1908,1933,2680,14850
島根県,3201,松江,毎日,1259,1702,1788,1551,1644,1539,1700,11183,439,662,520,381,445,342,376,3165
島根県,3201,松江,時々,1317,1511,1342,1100,925,751,778,7724,955,1183,1134,976,793,721,870,6632
島根県,3201,松江,ほとんど飲まない（飲めない）,1573,1773,1561,1242,1059,869,1075,9152,2039,2502,2357,2194,2088,2154,2991,16325
島根県,3202,雲南,毎日,327,447,395,405,531,536,607,3248,95,120,95,94,102,61,80,647
島根県,3202,雲南,時々,273,324,262,234,262,220,225,1800,226,269,240,206,227,204,211,1583
島根県,3202,雲南,ほとんど飲まない（飲めない）,317,370,270,250,261,276,339,2083,457,517,498,547,588,640,867,4114
島根県,3203,出雲,毎日,1009,1217,1271,1185,1316,1239,1428,8665,325,441,341,306,292,251,204,2160
島根県,3203,出雲,時々,907,1021,805,724,584,485,568,5094,607,745,627,593,497,540,560,4169
島根県,3203,出雲,ほとんど飲まない（飲めない）,1168,1328,1068,869,771,714,869,6787,1640,1822,1630,1579,1627,1810,2367,12475
島根県,3204,大田,毎日,269,352,296,339,417,449,531,2653,100,122,102,80,114,123,105,746
島根県,3204,大田,時々,216,265,214,163,180,163,160,1361,144,188,162,143,174,210,197,1218
島根県,3204,大田,ほとんど飲まない（飲めない）,317,325,300,264,270,262,370,2108,374,487,457,496,591,611,869,3885
島根県,3205,浜田,毎日,424,565,487,520,652,653,823,4124,148,216,174,158,176,151,164,1187
島根県,3205,浜田,時々,351,440,354,306,333,246,280,2310,251,261,286,262,238,250,333,1881
島根県,3205,浜田,ほとんど飲まない（飲めない）,466,528,467,408,376,417,532,3194,579,738,665,651,785,919,1326,5663
島根県,3206,益田,毎日,350,435,370,429,527,629,748,3488,99,156,129,114,142,145,152,937
島根県,3206,益田,時々,277,338,245,225,251,211,256,1803,197,250,198,204,226,256,326,1657
島根県,3206,益田,ほとんど飲まない（飲めない）,356,384,296,306,273,289,359,2263,429,506,481,484,563,746,1083,4292
島根県,3207,隠岐,毎日,116,157,134,124,164,160,190,1045,31,61,54,36,40,42,40,304
島根県,3207,隠岐,時々,107,82,65,72,40,60,79,505,79,85,48,56,61,54,66,449
島根県,3207,隠岐,ほとんど飲まない（飲めない）,126,119,66,85,84,116,137,733,154,163,153,160,163,242,358,1393
岡山県,3301,県南東部,毎日,4368,6275,6008,5556,5175,4596,4906,36884,1598,2241,2118,1668,1459,1123,1087,11294
岡山県,3301,県南東部,時々,5233,5998,5289,4138,3214,2136,1983,27991,3334,4143,3796,3026,2411,1841,2014,20565
岡山県,3301,県南東部,ほとんど飲まない（飲めない）,6979,8284,7118,5527,4300,3486,3948,39642,8269,10023,9661,8290,7379,7182,9614,60418
岡山県,3302,県南西部,毎日,3569,5086,4941,4302,4056,3650,3585,29189,1066,1654,1503,1144,981,730,649,7727
岡山県,3302,県南西部,時々,3923,4612,3913,2948,2307,1552,1481,20736,2470,3254,2863,2162,1600,1344,1442,15135
岡山県,3302,県南西部,ほとんど飲まない（飲めない）,5259,6225,5559,4114,3176,2452,2732,29517,5962,7528,7232,5807,5364,5286,6878,44057
岡山県,3303,高梁・新見,毎日,256,370,333,418,550,493,452,2872,79,118,93,102,113,76,56,637
岡山県,3303,高梁・新見,時々,240,268,221,201,224,168,157,1479,139,219,193,187,239,205,187,1369
岡山県,3303,高梁・新見,ほとんど飲まない（飲めない）,259,309,340,278,250,245,277,1958,388,444,439,489,563,585,677,3585
岡山県,3304,真庭,毎日,256,335,275,304,407,382,437,2396,83,101,91,93,95,76,82,621
岡山県,3304,真庭,時々,259,249,212,203,178,162,141,1404,154,192,188,170,180,196,182,1262
岡山県,3304,真庭,ほとんど飲まない（飲めない）,239,270,223,173,223,181,232,1541,358,384,357,441,463,507,618,3128
岡山県,3305,津山・英田,毎日,844,1168,1059,937,1142,1099,1138,7387,249,362,309,277,248,247,189,1881
岡山県,3305,津山・英田,時々,865,1011,796,635,605,438,428,4778,648,732,668,534,533,430,489,4034
岡山県,3305,津山・英田,ほとんど飲まない（飲めない）,1104,1231,1159,888,786,697,868,6733,1377,1659,1631,1480,1646,1595,1997,11385
広島県,3401,広島,毎日,8812,12277,12762,10810,9081,6109,5295,65146,3274,4733,4377,3351,2531,1568,1260,21094
広島県,3401,広島,時々,8652,10086,9011,6757,4835,2727,2178,44246,6237,7597,7160,5104,3592,2292,2142,34124
広島県,3401,広島,ほとんど飲まない（飲めない）,9065,10852,9879,7387,5286,3298,3175,48942,10123,12515,12321,9878,7619,5989,7094,65539
広島県,3402,広島西,毎日,683,984,1028,945,973,775,712,6100,241,336,344,306,243,202,149,1821
広島県,3402,広島西,時々,713,800,696,592,522,391,328,4042,495,609,615,509,413,311,260,3212
広島県,3402,広島西,ほとんど飲まない（飲めない）,847,976,830,711,573,431,436,4804,897,1119,1066,930,954,830,824,6620
広島県,3403,呉,毎日,960,1573,1537,1563,1361,1261,1302,9557,292,544,557,458,395,279,344,2869
広島県,3403,呉,時々,865,1125,1028,894,771,489,495,5667,678,823,796,649,544,442,574,4506
広島県,3403,呉,ほとんど飲まない（飲めない）,1140,1664,1563,1152,943,767,958,8187,1303,1875,1776,1716,1468,1528,2289,11955
広島県,3404,広島中央,毎日,1310,1861,1934,1707,1504,1130,1389,10835,370,598,530,452,400,237,281,2868
広島県,3404,広島中央,時々,1474,1593,1406,1086,847,534,587,7527,838,1077,952,714,634,545,661,5421
広島県,3404,広島中央,ほとんど飲まない（飲めない）,1643,1955,1700,1311,965,698,848,9120,1492,1949,1948,1649,1568,1463,2125,12194
広島県,3405,尾三,毎日,1155,1661,1638,1528,1657,1518,1580,10737,350,560,558,443,447,328,299,2985
広島県,3405,尾三,時々,1129,1321,1068,881,769,601,608,6377,749,1020,820,723,715,617,631,5275
広島県,3405,尾三,ほとんど飲まない（飲めない）,1503,1835,1587,1270,1095,923,1039,9252,1539,1996,2045,1911,1976,2028,2594,14089
広島県,3406,福山・府中,毎日,2720,3780,3581,3133,3009,2613,2543,21379,796,1264,1071,819,708,498,435,5591
広島県,3406,福山・府中,時々,2872,3226,2732,2078,1700,1168,1116,14892,1648,2015,1893,1473,1206,982,989,10206
広島県,3406,福山・府中,ほとんど飲まない（飲めない）,3689,4353,3687,2723,2174,1654,1893,20173,3974,4753,4630,3826,3490,3472,4222,28367
広島県,3407,備北,毎日,466,622,618,607,738,738,805,4594,178,252,208,208,217,199,176,1438
広島県,3407,備北,時々,394,446,353,316,300,247,270,2326,305,373,327,312,308,328,351,2304
広島県,3407,備北,ほとんど飲まない（飲めない）,487,565,508,392,385,347,358,3042,588,709,722,669,784,824,937,5233
山口県,3501,岩国,毎日,514,802,833,834,854,789,936,5562,175,282,283,242,192,212,210,1596
山口県,3501,岩国,時々,552,678,636,517,431,326,361,3501,372,471,522,372,353,348,395,2833
山口県,3501,岩国,ほとんど飲まない（飲めない）,610,793,728,572,495,479,549,4226,708,967,1030,908,897,1044,1498,7052
山口県,3502,柳井,毎日,299,472,486,401,474,489,504,3125,96,145,118,104,105,119,101,788
山口県,3502,柳井,時々,316,416,316,253,249,185,193,1928,201,239,293,215,211,185,240,1584
山口県,3502,柳井,ほとんど飲まない（飲めない）,393,474,428,346,315,310,315,2581,467,649,672,565,643,681,901,4578
山口県,3503,周南,毎日,1198,1896,1924,1613,1446,1380,1701,11158,359,579,564,434,401,374,415,3126
山口県,3503,周南,時々,1272,1600,1472,1039,775,581,640,7379,875,1102,1065,786,655,576,790,5849
山口県,3503,周南,ほとんど飲まない（飲めない）,1569,1892,1626,1145,1040,854,1130,9256,1668,2387,2215,1856,1799,2082,3290,15297
山口県,3504,山口・防府,毎日,1637,2389,2355,2129,2156,1785,2112,14563,523,730,677,516,521,443,451,3861
山口県,3504,山口・防府,時々,1783,2036,1728,1429,1168,805,705,9654,1093,1322,1283,991,893,761,928,7271
山口県,3504,山口・防府,ほとんど飲まない（飲めない）,2216,2551,2157,1652,1384,1070,1296,12326,2177,2663,2557,2301,2184,2316,3156,17354
山口県,3505,宇部・小野田,毎日,1289,1755,1687,1556,1508,1487,1742,11024,361,522,540,434,327,370,394,2948
山口県,3505,宇部・小野田,時々,1244,1423,1227,1036,852,678,727,7187,790,934,958,763,743,684,868,5740
山口県,3505,宇部・小野田,ほとんど飲まない（飲めない）,1463,1753,1452,1157,990,842,1116,8773,1627,1877,1989,1766,1732,2108,3043,14142
山口県,3506,下関,毎日,1168,1655,1594,1530,1523,1391,1350,10211,377,547,530,483,470,356,332,3095
山口県,3506,下関,時々,1139,1338,1147,951,816,603,592,6586,810,986,991,884,746,638,691,5746
山口県,3506,下関,ほとんど飲まない（飲めない）,1446,1751,1422,1108,912,803,917,8359,1571,1998,2113,1874,1788,1843,2695,13882
山口県,3507,長門,毎日,159,211,191,180,244,251,255,1491,31,49,44,63,55,68,57,367
山口県,3507,長門,時々,159,186,156,116,121,99,116,953,111,146,141,123,130,122,148,921
山口県,3507,長門,ほとんど飲まない（飲めない）,204,210,180,128,149,111,159,1141,234,257,287,251,346,347,443,2165
山口県,3508,萩,毎日,214,324,305,324,391,405,429,2392,60,97,92,67,82,88,86,572
山口県,3508,萩,時々,174,223,215,172,146,149,163,1242,112,171,161,153,170,176,179,1122
山口県,3508,萩,ほとんど飲まない（飲めない）,238,280,235,197,209,202,202,1563,266,354,407,403,428,539,692,3089
徳島県,3601,東部,毎日,2291,3081,3117,2914,2934,2763,3134,20234,835,1288,1223,1032,912,761,685,6736
徳島県,3601,東部,時々,2373,2582,2260,1891,1520,1158,1286,13070,1754,1958,1904,1628,1308,1294,1359,11205
徳島県,3601,東部,ほとんど飲まない（飲めない）,3581,3990,3483,2927,2423,2258,2936,21598,4014,4906,4702,4278,4230,5173,6807,34110
徳島県,3603,南部,毎日,713,946,897,867,960,972,1262,6617,206,304,342,281,266,234,249,1882
徳島県,3603,南部,時々,650,640,563,449,386,380,468,3536,391,483,438,418,403,447,513,3093
徳島県,3603,南部,ほとんど飲まない（飲めない）,903,1010,829,701,594,711,1017,5765,978,1149,1247,1128,1296,1680,2487,9965
徳島県,3605,西部,毎日,266,325,391,413,509,609,649,3162,87,143,144,112,117,112,97,812
徳島県,3605,西部,時々,235,293,242,240,233,238,269,1750,184,238,212,224,220,227,246,1551
徳島県,3605,西部,ほとんど飲まない（飲めない）,386,381,320,320,376,424,526,2733,466,530,545,647,785,974,1223,5170
香川県,3702,小豆,毎日,127,162,176,179,201,196,254,1295,45,56,54,52,42,48,43,340
香川県,3702,小豆,時々,114,104,95,71,58,52,61,555,85,92,71,68,56,49,96,517
香川県,3702,小豆,ほとんど飲まない（飲めない）,171,212,176,176,149,156,223,1263,210,255,268,264,307,376,517,2197
香川県,3706,東部,毎日,2534,3924,3846,3384,3152,2915,3461,23216,893,1380,1318,1026,867,768,867,7119
香川県,3706,東部,時々,2923,3467,2991,2174,1821,1334,1554,16264,1929,2454,2262,1757,1524,1326,1774,13026
香川県,3706,東部,ほとんど飲まない（飲めない）,4252,4981,4263,3302,2823,2533,3477,25631,4925,6135,5792,4817,4745,5224,8051,39689
香川県,3707,西部,毎日,1801,2600,2404,2275,2407,2365,2728,16580,569,879,798,614,652,533,522,4567
香川県,3707,西部,時々,1824,2178,1778,1432,1254,1022,1120,10608,1200,1550,1352,1128,1066,976,1112,8384
香川県,3707,西部,ほとんど飲まない（飲めない）,2887,3178,2850,2235,2063,1931,2671,17815,3262,3928,3768,3472,3677,4247,6366,28720
愛媛県,3801,宇摩,毎日,381,532,527,520,459,315,277,3011,117,155,143,118,75,48,42,698
愛媛県,3801,宇摩,時々,450,521,405,370,281,178,133,2338,239,320,256,245,161,117,96,1434
愛媛県,3801,宇摩,ほとんど飲まない（飲めない）,554,679,577,495,360,284,290,3239,616,744,769,638,568,578,563,4476
愛媛県,3802,新居浜・西条,毎日,974,1352,1288,1265,1145,809,771,7604,301,423,406,303,234,168,127,1962
愛媛県,3802,新居浜・西条,時々,1095,1349,1128,889,692,399,369,5921,670,869,766,648,448,302,284,3987
愛媛県,3802,新居浜・西条,ほとんど飲まない（飲めない）,1434,1696,1375,1154,924,657,649,7889,1570,1850,1768,1681,1433,1253,1489,11044
愛媛県,3803,今治,毎日,697,1029,1033,934,907,771,852,6223,216,332,353,273,226,160,153,1713
愛媛県,3803,今治,時々,790,932,765,578,493,361,388,4307,459,610,591,506,412,275,345,3198
愛媛県,3803,今治,ほとんど飲まない（飲めない）,1041,1226,1130,865,731,557,698,6248,1163,1457,1478,1269,1204,1137,1589,9297
愛媛県,3804,松山,毎日,2749,3899,3989,3624,3419,2539,1829,22048,932,1375,1313,1063,803,573,360,6419
愛媛県,3804,松山,時々,4166,4944,4149,3370,2665,1656,1161,22111,2631,3165,3040,2358,1801,1137,845,14977
愛媛県,3804,松山,ほとんど飲まない（飲めない）,5003,5681,4872,3700,3183,2037,1762,26238,5719,6622,6222,5349,4797,3764,3723,36196
愛媛県,3805,八幡浜・大洲,毎日,517,711,721,846,988,799,797,5379,160,232,215,206,168,143,90,1214
愛媛県,3805,八幡浜・大洲,時々,662,791,692,683,552,395,396,4171,434,511,551,512,474,366,339,3187
愛媛県,3805,八幡浜・大洲,ほとんど飲まない（飲めない）,746,910,750,683,651,517,508,4765,1027,1190,1319,1247,1248,1231,1413,8675
愛媛県,3806,宇和島,毎日,396,642,646,686,680,602,682,4334,172,239,230,207,160,119,109,1236
愛媛県,3806,宇和島,時々,521,574,514,460,404,289,341,3103,333,455,467,442,376,295,290,2658
愛媛県,3806,宇和島,ほとんど飲まない（飲めない）,613,723,562,538,502,417,487,3842,768,1030,1021,997,1098,1140,1394,7448
高知県,3901,安芸,毎日,205,261,299,316,346,356,394,2177,49,126,119,107,108,83,116,708
高知県,3901,安芸,時々,189,218,187,174,132,112,144,1156,119,130,133,114,138,150,186,970
高知県,3901,安芸,ほとんど飲まない（飲めない）,217,242,228,198,194,182,286,1547,267,331,350,388,410,591,807,3144
高知県,3902,中央,毎日,2787,3988,3744,3499,3547,3174,3570,24309,1187,1679,1625,1330,1280,1068,1128,9297
高知県,3902,中央,時々,2709,3042,2531,2056,1607,1173,1237,14355,2106,2533,2283,1887,1569,1290,1358,13026
高知県,3902,中央,ほとんど飲まない（飲めない）,3287,3920,3199,2463,1998,1859,2208,18934,4069,4919,4749,4255,4051,4095,5728,31866
高知県,3903,高幡,毎日,278,347,412,399,513,577,665,3191,103,162,129,136,169,158,156,1013
高知県,3903,高幡,時々,229,232,197,172,172,139,164,1305,148,175,181,175,157,193,197,1226
高知県,3903,高幡,ほとんど飲まない（飲めない）,261,288,244,196,194,215,316,1714,282,386,375,400,479,620,838,3380
高知県,3904,幡多,毎日,345,494,461,483,576,649,767,3775,147,235,212,177,195,203,185,1354
高知県,3904,幡多,時々,313,395,318,228,217,210,231,1912,266,325,287,269,246,255,297,1945
高知県,3904,幡多,ほとんど飲まない（飲めない）,392,420,344,280,315,341,491,2583,503,647,628,619,743,1016,1426,5582
福岡県,4001,福岡・糸島,毎日,9752,12213,12121,10222,8641,6638,6375,65962,4214,5404,4801,3669,2796,1949,1816,24649
福岡県,4001,福岡・糸島,時々,11380,11813,10221,7609,5692,3830,3538,54083,9242,9860,8802,6670,4811,3581,3573,46539
福岡県,4001,福岡・糸島,ほとんど飲まない（飲めない）,10569,11006,9586,7192,5643,4406,4999,53401,13038,13867,12834,10537,9107,8620,10919,78922
福岡県,4002,粕屋,毎日,1861,2445,2041,1608,1638,1401,1376,12370,683,851,738,553,480,364,332,4001
福岡県,4002,粕屋,時々,1961,2096,1578,1146,870,733,679,9063,1453,1571,1230,952,795,706,716,7423
福岡県,4002,粕屋,ほとんど飲まない（飲めない）,2192,2468,1893,1278,1157,932,1056,10976,2471,2713,2219,1795,1757,1825,2240,15020
福岡県,4003,宗像,毎日,840,957,871,774,983,845,976,6246,319,367,330,297,282,224,193,2012
福岡県,4003,宗像,時々,961,933,746,624,531,521,492,4808,696,748,629,564,527,475,505,4144
福岡県,4003,宗像,ほとんど飲まない（飲めない）,1165,1089,864,680,625,568,691,5682,1313,1317,1215,1085,1114,1323,1621,8988
福岡県,4004,筑紫,毎日,2299,3038,2959,2586,2448,2034,2124,17488,885,1227,1114,922,709,553,528,5938
福岡県,4004,筑紫,時々,2666,2935,2524,1930,1521,1202,1186,13964,2014,2417,2164,1707,1402,1127,1213,12044
福岡県,4004,筑紫,ほとんど飲まない（飲めない）,2650,2914,2443,1818,1570,1320,1563,14278,3273,3646,3543,2951,2619,2654,3550,22236
福岡県,4005,朝倉,毎日,456,523,528,492,555,580,678,3812,139,195,175,152,169,153,93,1076
福岡県,4005,朝倉,時々,499,496,399,319,315,292,292,2612,327,367,348,318,270,314,320,2264
福岡県,4005,朝倉,ほとんど飲まない（飲めない）,497,528,423,360,317,350,365,2840,582,677,632,662,698,822,1051,5124
福岡県,4006,久留米,毎日,2158,2714,2633,2558,2625,2475,2681,17844,763,1011,964,815,726,657,541,5477
福岡県,4006,久留米,時々,2295,2358,2095,1741,1553,1206,1316,12564,1768,2107,2029,1684,1424,1366,1505,11883
福岡県,4006,久留米,ほとんど飲まない（飲めない）,2492,2774,2274,1865,1638,1562,1906,14511,3043,3457,3555,3263,3154,3544,4812,24828
福岡県,4007,八女・筑後,毎日,686,796,791,792,925,844,911,5745,212,286,297,249,227,170,152,1593
福岡県,4007,八女・筑後,時々,698,662,579,517,463,421,453,3793,474,606,587,530,474,492,467,3630
福岡県,4007,八女・筑後,ほとんど飲まない（飲めない）,696,783,664,588,553,504,607,4395,934,986,1028,1080,1116,1266,1618,8028
福岡県,4008,有明,毎日,862,1088,1177,1230,1270,1247,1368,8242,281,410,375,423,341,336,291,2457
福岡県,4008,有明,時々,843,911,789,700,657,542,648,5090,631,747,743,702,636,659,738,4856
福岡県,4008,有明,ほとんど飲まない（飲めない）,935,956,868,813,818,764,1052,6206,1159,1360,1400,1449,1512,1879,2786,11545
福岡県,4009,飯塚,毎日,914,1108,955,898,1065,1033,1223,7196,418,492,418,339,403,350,393,2813
福岡県,4009,飯塚,時々,747,741,602,457,534,437,574,4092,615,721,630,505,540,543,685,4239
福岡県,4009,飯塚,ほとんど飲まない（飲めない）,986,1099,853,718,682,713,952,6003,1214,1416,1278,1144,1333,1600,2235,10220
福岡県,4010,直方・鞍手,毎日,573,615,586,533,663,603,750,4323,178,217,221,178,189,170,151,1304
福岡県,4010,直方・鞍手,時々,474,484,347,294,314,278,311,2502,289,340,340,276,294,339,361,2239
福岡県,4010,直方・鞍手,ほとんど飲まない（飲めない）,700,732,582,460,439,440,549,3902,741,741,758,700,737,883,1308,5868
福岡県,4011,田川,毎日,544,700,634,594,676,704,697,4549,232,291,277,218,239,201,183,1641
福岡県,4011,田川,時々,401,428,362,275,307,234,290,2297,309,361,352,316,252,302,348,2240
福岡県,4011,田川,ほとんど飲まない（飲めない）,594,669,547,436,414,472,588,3720,755,904,794,809,875,1040,1285,6462
福岡県,4012,北九州,毎日,5484,7147,7093,6365,6333,5688,6477,44587,2000,2816,2708,2234,2009,1643,1777,15187
福岡県,4012,北九州,時々,5474,6046,5360,4377,3756,2879,3022,30914,3876,4502,4475,3715,3087,2841,3530,26026
福岡県,4012,北九州,ほとんど飲まない（飲めない）,6701,7509,6649,5144,4407,3950,4810,39170,7486,8867,9017,7846,7132,7878,11928,60154
福岡県,4013,京築,毎日,988,1377,1332,1236,1258,1237,1314,8742,327,464,381,316,284,259,256,2287
福岡県,4013,京築,時々,917,975,867,688,627,546,585,5205,589,741,693,548,566,540,622,4299
福岡県,4013,京築,ほとんど飲まない（飲めない）,1212,1437,1198,944,826,742,967,7326,1328,1612,1589,1438,1477,1819,2399,11662
佐賀県,4101,中部,毎日,1778,2096,2160,2246,2286,2178,2174,14918,590,811,709,651,563,482,397,4203
佐賀県,4101,中部,時々,1742,1890,1685,1435,1246,986,1026,10010,1261,1488,1359,1199,1068,934,855,8164
佐賀県,4101,中部,ほとんど飲まない（飲めない）,2181,2362,2035,1755,1449,1485,1617,12884,2711,3071,3077,2946,2929,3229,3830,21793
佐賀県,4102,東部,毎日,752,876,820,755,722,740,822,5487,197,290,274,160,208,180,168,1477
佐賀県,4102,東部,時々,792,779,647,499,455,373,414,3959,449,573,514,381,371,343,379,3010
佐賀県,4102,東部,ほとんど飲まない（飲めない）,941,1002,779,636,509,482,656,5005,982,1064,1021,843,876,1110,1620,7516
佐賀県,4103,北部,毎日,569,667,581,635,733,675,744,4604,240,280,234,248,213,154,117,1486
佐賀県,4103,北部,時々,587,625,540,470,442,413,452,3529,443,520,428,435,406,388,340,2960
佐賀県,4103,北部,ほとんど飲まない（飲めない）,550,641,501,469,461,488,547,3657,815,911,851,911,1063,1160,1375,7086
佐賀県,4104,西部,毎日,394,455,480,509,585,573,565,3561,148,168,139,142,141,107,117,962
佐賀県,4104,西部,時々,440,433,359,333,315,262,260,2402,280,321,283,287,280,266,259,1976
佐賀県,4104,西部,ほとんど飲まない（飲めない）,482,429,384,327,268,320,385,2595,570,564,590,625,661,850,1119,4979
佐賀県,4105,南部,毎日,667,811,790,998,1008,1124,1262,6660,230,273,285,255,278,240,185,1746
佐賀県,4105,南部,時々,639,617,580,595,541,452,499,3923,383,472,449,397,452,442,520,3115
佐賀県,4105,南部,ほとんど飲まない（飲めない）,683,689,641,600,591,577,794,4575,871,985,1011,1153,1340,1748,2291,9399
長崎県,4201,長崎,毎日,2094,2960,3228,3185,3165,3060,3400,21092,809,1112,1039,970,868,755,705,6258
長崎県,4201,長崎,時々,2443,2833,2641,2271,1906,1562,1742,15398,1989,2335,2267,1968,1762,1471,1685,13477
長崎県,4201,長崎,ほとんど飲まない（飲めない）,2648,3073,2892,2405,2178,2011,2569,17776,3475,4150,4206,3975,3905,4782,6613,31106
長崎県,4202,佐世保県北,毎日,1088,1491,1468,1559,1631,1714,1818,10769,382,528,487,413,391,362,345,2908
長崎県,4202,佐世保県北,時々,1147,1275,1098,1065,925,793,916,7219,987,1072,1012,937,830,847,899,6584
長崎県,4202,佐世保県北,ほとんど飲まない（飲めない）,1277,1368,1232,1073,1061,1125,1473,8609,1664,1922,2013,1883,2055,2760,3716,16013
長崎県,4203,県央,毎日,1281,1595,1730,1752,1796,1711,1738,11603,391,487,499,412,317,322,309,2737
長崎県,4203,県央,時々,1451,1601,1334,1185,979,832,812,8194,1058,1230,1133,1003,868,756,853,6901
長崎県,4203,県央,ほとんど飲まない（飲めない）,1507,1701,1449,1183,1037,981,1184,9042,1936,2095,2219,2113,2184,2632,3435,16614
長崎県,4204,県南,毎日,461,532,658,759,860,892,974,5136,144,172,175,147,161,141,113,1053
長崎県,4204,県南,時々,480,553,530,470,495,415,495,3438,366,436,467,449,431,393,410,2952
長崎県,4204,県南,ほとんど飲まない（飲めない）,566,656,568,598,621,657,862,4528,816,985,1114,1224,1455,1867,2336,9797
長崎県,4206,五島,毎日,111,135,153,170,214,246,258,1287,28,39,51,48,40,47,40,293
長崎県,4206,五島,時々,151,149,129,149,125,137,127,967,105,105,113,106,105,104,90,728
長崎県,4206,五島,ほとんど飲まない（飲めない）,135,177,181,148,163,195,225,1224,195,214,245,275,399,490,591,2409
長崎県,4207,上五島,毎日,90,110,130,160,153,174,143,960,14,23,21,36,30,25,13,162
長崎県,4207,上五島,時々,82,95,84,80,79,80,77,577,39,72,54,63,57,54,47,386
長崎県,4207,上五島,ほとんど飲まない（飲めない）,127,142,117,137,148,134,138,943,132,154,169,217,255,292,368,1587
長崎県,4208,壱岐,毎日,141,157,171,185,178,205,237,1274,50,55,48,35,32,32,27,279
長崎県,4208,壱岐,時々,115,133,118,99,112,99,115,791,94,110,90,111,91,89,102,687
長崎県,4208,壱岐,ほとんど飲まない（飲めない）,99,116,120,90,106,119,177,827,191,206,178,231,257,340,482,1885
長崎県,4209,対馬,毎日,121,171,165,175,219,235,216,1302,36,57,34,43,36,29,18,253
長崎県,4209,対馬,時々,134,130,130,106,106,135,147,888,101,114,107,88,107,106,103,726
長崎県,4209,対馬,ほとんど飲まない（飲めない）,134,160,125,115,159,165,233,1091,198,208,232,265,338,465,557,2263
熊本県,4302,宇城,毎日,513,631,658,723,753,750,780,4808,177,226,211,209,187,159,108,1277
熊本県,4302,宇城,時々,540,576,455,509,447,373,383,3283,382,420,421,353,335,317,330,2558
熊本県,4302,宇城,ほとんど飲まない（飲めない）,583,578,545,531,447,432,473,3589,747,834,872,873,991,1103,1354,6774
熊本県,4303,有明,毎日,863,835,889,928,1033,1145,1210,6903,255,329,304,239,296,217,191,1831
熊本県,4303,有明,時々,774,711,599,556,534,497,549,4220,543,637,583,528,538,546,553,3928
熊本県,4303,有明,ほとんど飲まない（飲めない）,842,911,767,688,634,664,794,5300,1058,1214,1149,1270,1369,1613,2070,9743
熊本県,4304,鹿本,毎日,259,276,324,344,414,373,448,2438,103,108,112,94,84,90,64,655
熊本県,4304,鹿本,時々,262,276,251,214,202,227,252,1684,183,215,211,189,206,224,235,1463
熊本県,4304,鹿本,ほとんど飲まない（飲めない）,307,283,260,232,243,249,287,1861,342,387,442,485,504,607,807,3574
熊本県,4305,菊池,毎日,1206,1365,1204,1176,1175,1130,1041,8297,461,487,370,333,300,264,195,2410
熊本県,4305,菊池,時々,1510,1393,1051,954,785,625,613,6931,1061,1002,830,756,635,528,466,5278
熊本県,4305,菊池,ほとんど飲まない（飲めない）,1329,1491,1076,918,770,672,638,6894,1725,1776,1531,1448,1482,1492,1721,11175
熊本県,4306,阿蘇,毎日,333,333,353,413,500,647,646,3225,111,139,137,129,131,137,101,885
熊本県,4306,阿蘇,時々,338,330,311,330,315,344,372,2340,259,297,270,290,307,340,303,2066
熊本県,4306,阿蘇,ほとんど飲まない（飲めない）,295,339,278,289,306,360,419,2286,460,487,536,608,714,923,1146,4874
熊本県,4308,八代,毎日,691,839,869,941,942,857,776,5915,267,355,280,272,253,167,149,1743
熊本県,4308,八代,時々,675,744,620,571,511,394,403,3918,491,565,506,478,463,437,394,3334
熊本県,4308,八代,ほとんど飲まない（飲めない）,800,814,755,658,553,499,553,4632,978,1160,1184,1233,1283,1352,1461,8651
熊本県,4309,芦北,毎日,185,233,306,310,353,336,285,2008,67,78,67,72,79,62,41,466
熊本県,4309,芦北,時々,185,214,219,219,185,143,144,1309,131,153,161,163,152,141,119,1020
熊本県,4309,芦北,ほとんど飲まない（飲めない）,229,229,226,234,201,189,177,1485,261,296,372,400,419,492,489,2729
熊本県,4310,球磨,毎日,582,654,715,849,942,978,1010,5730,219,297,268,247,244,264,236,1775
熊本県,4310,球磨,時々,415,454,390,400,427,376,436,2898,398,427,410,431,439,456,518,3079
熊本県,4310,球磨,ほとんど飲まない（飲めない）,396,465,376,368,392,419,494,2910,642,675,741,819,949,1095,1441,6362
熊本県,4311,天草,毎日,526,652,745,822,1020,1021,996,5782,223,276,256,279,265,220,146,1665
熊本県,4311,天草,時々,536,552,493,497,503,453,472,3506,396,475,438,480,467,453,417,3126
熊本県,4311,天草,ほとんど飲まない（飲めない）,541,585,566,505,550,525,591,3863,825,931,1095,1215,1356,1593,1714,8729
熊本県,4312,熊本・上益城,毎日,4092,5172,4994,4892,4760,4336,4165,32411,1722,2169,1815,1599,1415,1169,1054,10943
熊本県,4312,熊本・上益城,時々,5046,5456,4572,4186,3464,2645,2308,27677,3899,4517,3998,3445,2840,2330,2316,23345
熊本県,4312,熊本・上益城,ほとんど飲まない（飲めない）,4810,5253,4434,3817,3288,2643,2748,26993,6347,7193,6902,6533,5842,5925,7290,46032
大分県,4401,東部,毎日,759,1037,1085,1089,1215,1321,1536,8042,309,452,449,411,372,355,351,2699
大分県,4401,東部,時々,756,872,712,719,659,607,688,5013,692,831,817,711,659,621,718,5049
大分県,4401,東部,ほとんど飲まない（飲めない）,1051,1157,1070,821,917,837,1111,6964,1381,1588,1701,1717,1836,2061,3027,13311
大分県,4403,中部,毎日,3028,4121,3903,3612,3791,3461,3453,25369,1142,1462,1393,1092,961,799,673,7522
大分県,4403,中部,時々,3230,3544,3082,2376,2190,1660,1583,17665,2342,2735,2515,1944,1766,1387,1461,14150
大分県,4403,中部,ほとんど飲まない（飲めない）,4050,4599,3582,2968,2660,2370,2627,22856,4966,5818,5398,4925,4889,5120,6699,37815
大分県,4405,南部,毎日,292,373,385,414,499,567,577,3107,106,119,139,97,112,86,82,741
大分県,4405,南部,時々,275,282,232,259,218,204,205,1675,216,222,236,232,224,173,168,1471
大分県,4405,南部,ほとんど飲まない（飲めない）,387,436,373,360,347,423,568,2894,491,577,620,650,783,1070,1438,5629
大分県,4406,豊肥,毎日,203,260,281,321,518,500,635,2718,84,115,101,86,138,125,128,777
大分県,4406,豊肥,時々,194,183,193,173,207,209,234,1393,178,159,156,171,240,237,257,1398
大分県,4406,豊肥,ほとんど飲まない（飲めない）,287,321,274,231,277,298,407,2095,374,425,448,473,649,776,997,4142
大分県,4408,西部,毎日,484,573,566,631,732,723,730,4439,164,176,182,145,172,138,123,1100
大分県,4408,西部,時々,350,458,390,384,371,319,318,2590,291,364,324,392,348,349,385,2453
大分県,4408,西部,ほとんど飲まない（飲めない）,473,507,440,430,456,399,432,3137,606,695,726,733,843,878,1135,5616
大分県,4409,北部,毎日,938,1204,1179,1184,1154,1097,1089,7845,290,372,317,295,235,204,193,1906
大分県,4409,北部,時々,885,865,716,621,577,487,550,4701,527,623,629,581,512,489,541,3902
大分県,4409,北部,ほとんど飲まない（飲めない）,1091,1096,937,778,737,658,727,6024,1108,1237,1290,1175,1460,1637,2062,9969
宮崎県,4501,宮崎東諸県,毎日,2784,3432,3297,3035,2915,2597,2370,20430,972,1346,1147,873,741,635,525,6239
宮崎県,4501,宮崎東諸県,時々,2523,2895,2435,2015,1706,1128,1112,13814,1970,2435,2171,1787,1433,1190,1215,12201
宮崎県,4501,宮崎東諸県,ほとんど飲まない（飲めない）,2429,2761,2305,1920,1602,1330,1476,13823,3176,3692,3503,3238,3009,3059,3933,23610
宮崎県,4502,都城北諸県,毎日,1228,1317,1154,1221,1493,1493,1725,9631,351,412,368,295,357,350,343,2476
宮崎県,4502,都城北諸県,時々,921,952,757,639,676,525,629,5099,714,777,702,686,663,699,789,5030
宮崎県,4502,都城北諸県,ほとんど飲まない（飲めない）,932,974,823,709,740,723,1035,5936,1213,1365,1354,1374,1686,2200,3055,12247
宮崎県,4503,延岡西臼杵,毎日,897,1157,1184,1168,1224,1144,1290,8064,278,412,351,307,282,238,240,2108
宮崎県,4503,延岡西臼杵,時々,862,905,809,744,574,465,584,4943,597,684,647,572,546,594,642,4282
宮崎県,4503,延岡西臼杵,ほとんど飲まない（飲めない）,933,1093,970,760,656,610,845,5867,936,1127,1136,1142,1257,1545,2145,9288
宮崎県,4504,日南串間,毎日,283,346,369,380,499,523,554,2954,77,99,118,108,113,86,97,698
宮崎県,4504,日南串間,時々,259,258,256,215,243,191,199,1621,190,196,164,192,214,244,271,1471
宮崎県,4504,日南串間,ほとんど飲まない（飲めない）,262,262,218,243,216,239,308,1748,316,352,369,461,501,667,946,3612
宮崎県,4505,西諸,毎日,370,386,380,455,594,626,756,3567,135,145,134,143,155,152,139,1003
宮崎県,4505,西諸,時々,277,249,209,239,213,221,275,1683,194,207,203,229,265,293,362,1753
宮崎県,4505,西諸,ほとんど飲まない（飲めない）,273,273,229,230,271,312,439,2027,394,386,376,513,597,831,1117,4214
宮崎県,4506,西都児湯,毎日,480,604,575,586,702,828,835,4610,182,235,211,167,184,198,164,1341
宮崎県,4506,西都児湯,時々,394,397,313,309,283,318,334,2348,318,380,358,302,337,348,416,2459
宮崎県,4506,西都児湯,ほとんど飲まない（飲めない）,406,435,352,348,334,361,502,2738,564,675,629,696,773,1028,1388,5753
宮崎県,4507,日向入郷,毎日,483,588,519,541,578,609,644,3962,149,193,166,133,146,116,115,1018
宮崎県,4507,日向入郷,時々,403,432,365,332,274,273,335,2414,382,373,342,292,304,294,325,2312
宮崎県,4507,日向入郷,ほとんど飲まない（飲めない）,394,425,315,310,272,296,369,2381,493,549,613,562,590,746,1139,4692
鹿児島県,4601,鹿児島,毎日,3326,4133,3943,3903,4182,3962,4466,27915,1114,1385,1178,941,848,742,683,6891
鹿児島県,4601,鹿児島,時々,3903,4339,3678,3148,2875,2262,2213,22418,2930,3255,2931,2347,2096,1939,1961,17459
鹿児島県,4601,鹿児島,ほとんど飲まない（飲めない）,3557,3925,3367,3000,2738,2603,3076,22266,4422,4970,4998,4870,5075,6201,8440,38976
鹿児島県,4603,南薩,毎日,559,577,658,747,1015,1296,1542,6394,139,171,174,172,147,173,161,1137
鹿児島県,4603,南薩,時々,446,493,453,443,450,470,513,3268,334,346,328,393,395,508,517,2821
鹿児島県,4603,南薩,ほとんど飲まない（飲めない）,465,481,458,504,528,667,826,3929,623,715,798,911,1363,1926,2623,8959
鹿児島県,4605,川薩,毎日,637,727,734,863,1014,1081,1294,6350,179,237,198,164,218,199,191,1386
鹿児島県,4605,川薩,時々,544,582,467,546,454,431,520,3544,356,412,418,408,403,460,524,2981
鹿児島県,4605,川薩,ほとんど飲まない（飲めない）,608,652,589,592,558,624,842,4465,820,847,960,1057,1202,1627,2143,8656
鹿児島県,4606,出水,毎日,439,456,504,577,609,722,774,4081,131,163,140,136,137,134,107,948
鹿児島県,4606,出水,時々,299,318,322,269,239,224,298,1969,233,265,243,224,232,254,283,1734
鹿児島県,4606,出水,ほとんど飲まない（飲めない）,397,414,371,364,316,313,415,2590,520,593,659,701,766,1069,1277,5585
鹿児島県,4607,姶良・伊佐,毎日,1237,1522,1476,1691,1815,1787,2214,11742,401,447,431,364,392,392,428,2855
鹿児島県,4607,姶良・伊佐,時々,1228,1266,1187,1075,990,749,869,7364,900,1006,918,881,753,861,959,6278
鹿児島県,4607,姶良・伊佐,ほとんど飲まない（飲めない）,1241,1335,1295,1148,1024,988,1253,8284,1533,1790,1952,1990,2215,2489,3524,15493
鹿児島県,4609,曽於,毎日,367,372,414,463,665,642,686,3609,117,119,94,130,137,133,104,834
鹿児島県,4609,曽於,時々,279,278,252,256,240,216,251,1772,214,206,207,226,275,239,280,1647
鹿児島県,4609,曽於,ほとんど飲まない（飲めない）,287,286,297,303,316,338,413,2240,349,389,463,541,673,853,1037,4305
鹿児島県,4610,肝属,毎日,749,814,838,925,1155,1195,1311,6987,192,236,263,212,258,220,202,1583
鹿児島県,4610,肝属,時々,625,588,490,494,479,451,443,3570,452,497,454,475,443,481,543,3345
鹿児島県,4610,肝属,ほとんど飲まない（飲めない）,745,686,629,597,627,635,774,4693,850,956,1018,1076,1380,1674,2084,9038
鹿児島県,4611,熊毛,毎日,196,238,254,317,316,322,311,1954,64,66,66,51,61,75,53,436
鹿児島県,4611,熊毛,時々,165,191,209,159,138,140,140,1142,138,117,141,101,117,125,130,869
鹿児島県,4611,熊毛,ほとんど飲まない（飲めない）,167,185,159,135,159,162,198,1165,192,237,252,251,307,449,534,2222
鹿児島県,4612,奄美,毎日,468,616,648,659,776,928,874,4969,213,229,179,153,163,158,125,1220
鹿児島県,4612,奄美,時々,522,508,436,508,419,430,419,3242,404,447,406,384,399,393,358,2791
鹿児島県,4612,奄美,ほとんど飲まない（飲めない）,318,343,311,304,320,377,440,2413,566,582,602,662,895,1296,1486,6089
沖縄県,4701,北部,毎日,545,553,495,443,579,535,476,3626,179,204,120,113,103,78,39,836
沖縄県,4701,北部,時々,670,736,543,557,571,589,498,4164,534,559,361,397,353,268,187,2659
沖縄県,4701,北部,ほとんど飲まない（飲めない）,327,396,318,313,333,470,578,2735,576,571,591,698,904,1064,1198,5602
沖縄県,4702,中部,毎日,2203,2733,2399,1991,1597,1317,933,13173,904,1056,825,542,339,199,90,3955
沖縄県,4702,中部,時々,2710,3333,2894,2381,1855,1282,1075,15530,2100,2580,2040,1538,1058,699,447,10462
沖縄県,4702,中部,ほとんど飲まない（飲めない）,2314,2646,2293,1843,1567,1251,1261,13175,3402,4077,3965,3439,3078,2739,2822,23522
沖縄県,4703,南部,毎日,3470,4227,4005,3325,2861,2501,2164,22553,1620,1832,1517,999,717,484,280,7449
沖縄県,4703,南部,時々,4916,5550,5007,4057,3346,2624,2341,27841,3968,4478,3949,2998,2211,1671,1199,20474
沖縄県,4703,南部,ほとんど飲まない（飲めない）,3434,3972,3380,2770,2365,2192,2442,20555,5114,5771,5858,5462,5052,5270,5836,38363
沖縄県,4704,宮古,毎日,242,291,262,307,316,293,242,1953,108,141,98,69,48,39,29,532
沖縄県,4704,宮古,時々,381,374,326,344,352,405,271,2453,272,271,216,206,208,148,99,1420
沖縄県,4704,宮古,ほとんど飲まない（飲めない）,125,171,131,129,168,171,207,1102,300,267,272,383,530,604,574,2930
沖縄県,4705,八重山,毎日,326,362,408,325,388,391,286,2486,161,184,145,115,80,70,36,791
沖縄県,4705,八重山,時々,314,343,290,258,267,252,231,1955,284,290,259,206,200,161,109,1509
沖縄県,4705,八重山,ほとんど飲まない（飲めない）,165,171,134,107,129,128,152,986,251,275,231,250,330,399,405,2141
二次医療圏判別不可,,,毎日,15834,21439,24592,24088,14133,4541,2648,107275,5056,6837,6597,4898,2813,946,436,27583
二次医療圏判別不可,,,時々,30483,30851,29907,26601,12568,3135,1781,135326,13371,15212,14451,10633,5273,1903,1013,61856
二次医療圏判別不可,,,ほとんど飲まない（飲めない）,26923,28259,26773,22386,11104,3123,2118,120686,22789,26219,25896,20848,11444,5067,3256,115519
