都道府県名,二次医療圏番号,二次医療圏名,回答,男40～44歳,男45～49歳,男50～54歳,男55～59歳,男60～64歳,男65～69歳,男70～74歳,男中計,女40～44歳,女45～49歳,女50～54歳,女55～59歳,女60～64歳,女65～69歳,女70～74歳,女中計
北海道,0101,南渡島,はい,1610,1948,1653,1438,1040,769,727,9185,769,979,1002,820,540,431,422,4963
北海道,0101,南渡島,いいえ,2888,3796,3517,3232,3198,3005,3408,23044,2741,3617,3619,3337,3337,3594,4735,24980
北海道,0102,南檜山,はい,77,93,94,90,79,59,47,539,48,58,53,48,32,22,37,298
北海道,0102,南檜山,いいえ,196,257,239,215,222,206,228,1563,160,180,195,193,224,243,326,1521
北海道,0103,北渡島檜山,はい,120,140,127,110,76,73,67,713,40,49,61,53,46,42,56,347
北海道,0103,北渡島檜山,いいえ,276,310,303,280,283,275,293,2020,208,275,228,260,255,312,366,1904
北海道,0104,札幌,はい,15312,18013,16316,12544,8556,4657,2444,77842,6909,8221,7525,5755,3350,1453,909,34122
北海道,0104,札幌,いいえ,22142,26770,26086,24164,22806,14288,8762,145018,22548,26925,25958,22228,16930,9890,7140,131619
北海道,0105,後志,はい,886,1159,1092,870,639,525,474,5645,396,574,517,428,285,200,306,2706
北海道,0105,後志,いいえ,1632,2111,1997,1972,1851,1718,1829,13110,1376,1858,1839,1775,1757,1861,2413,12879
北海道,0106,南空知,はい,613,842,740,637,577,425,335,4169,263,418,417,341,270,163,211,2083
北海道,0106,南空知,いいえ,1151,1616,1435,1561,1596,1465,1407,10231,1070,1427,1464,1467,1462,1431,1764,10085
北海道,0107,中空知,はい,348,508,477,439,343,248,249,2612,193,279,241,238,175,139,168,1433
北海道,0107,中空知,いいえ,741,1086,991,1023,1013,926,1117,6897,785,987,967,1021,981,1104,1494,7339
北海道,0108,北空知,はい,58,115,101,110,85,70,79,618,48,44,47,41,32,32,48,292
北海道,0108,北空知,いいえ,218,266,252,291,318,302,366,2013,222,259,291,290,300,354,467,2183
北海道,0109,西胆振,はい,767,1043,871,692,516,385,393,4667,350,458,444,354,241,192,256,2295
北海道,0109,西胆振,いいえ,1405,1951,1814,1618,1582,1587,2018,11975,1243,1662,1663,1553,1519,1782,2568,11990
北海道,0110,東胆振,はい,1541,1797,1362,1167,724,549,523,7663,494,617,544,478,317,233,271,2954
北海道,0110,東胆振,いいえ,2168,2834,2480,2211,2125,2056,2255,16129,1818,2210,2004,1861,1739,2171,2816,14619
北海道,0111,日高,はい,214,236,228,172,134,95,130,1209,106,133,137,101,62,61,74,674
北海道,0111,日高,いいえ,513,671,566,516,494,446,413,3619,393,507,471,459,456,480,563,3329
北海道,0112,上川中部,はい,1606,1897,1659,1372,1028,527,356,8445,671,842,870,604,422,194,170,3773
北海道,0112,上川中部,いいえ,2721,3437,3159,2920,2898,1987,1308,18430,2532,3098,2988,2529,2014,1327,1202,15690
北海道,0113,上川北部,はい,180,217,189,180,198,91,109,1164,80,116,82,92,56,58,57,541
北海道,0113,上川北部,いいえ,453,613,582,578,503,428,403,3560,385,435,421,399,449,416,527,3032
北海道,0114,富良野,はい,178,183,182,174,127,105,120,1069,102,90,82,78,70,58,87,567
北海道,0114,富良野,いいえ,346,454,431,481,481,450,525,3168,362,481,495,457,463,510,708,3476
北海道,0115,留萌,はい,126,176,189,152,116,105,95,959,74,117,77,81,68,63,69,549
北海道,0115,留萌,いいえ,356,500,461,429,439,375,371,2931,281,366,406,374,403,423,571,2824
北海道,0116,宗谷,はい,271,354,276,264,212,169,132,1678,122,144,125,117,86,66,61,721
北海道,0116,宗谷,いいえ,614,782,708,675,638,563,479,4459,506,548,524,496,476,463,546,3559
北海道,0117,北網,はい,872,1069,874,757,638,365,347,4922,376,479,400,369,264,191,250,2329
北海道,0117,北網,いいえ,1913,2445,2233,2147,2090,1621,1773,14222,1668,2083,1961,2004,1885,1824,2354,13779
北海道,0118,遠紋,はい,238,289,250,227,166,129,135,1434,101,123,127,122,90,62,99,724
北海道,0118,遠紋,いいえ,518,687,700,696,646,531,641,4419,389,499,557,543,532,647,888,4055
北海道,0119,十勝,はい,1583,1848,1649,1378,1067,722,659,8906,711,883,820,690,450,403,441,4398
北海道,0119,十勝,いいえ,2934,3731,3386,3367,3348,2964,3146,22876,2683,3400,3347,3182,3073,3171,3929,22785
北海道,0120,釧路,はい,1117,1342,1187,1001,813,565,508,6533,532,685,640,501,397,308,276,3339
北海道,0120,釧路,いいえ,2009,2587,2468,2268,2302,2032,2197,15863,1752,2262,2184,2039,2020,2263,2690,15210
北海道,0121,根室,はい,304,342,263,226,191,127,111,1564,158,166,151,137,101,69,85,867
北海道,0121,根室,いいえ,646,768,679,678,600,509,490,4370,556,613,604,554,552,564,554,3997
青森県,0201,津軽地域,はい,1398,1633,1498,1388,1069,660,487,8133,733,854,826,685,491,274,289,4152
青森県,0201,津軽地域,いいえ,2440,2616,2473,2402,2357,1743,1623,15654,2349,2731,2681,2898,2375,1996,1966,16996
青森県,0202,八戸地域,はい,2394,2963,2957,2456,2035,1410,1176,15391,1252,1551,1503,1255,952,777,824,8114
青森県,0202,八戸地域,いいえ,3481,4132,4105,3817,3862,3275,3245,25917,3112,4018,4163,3812,3751,3666,4013,26535
青森県,0203,青森地域,はい,2060,2558,2360,2196,1690,1091,1009,12964,1049,1324,1183,1040,763,529,671,6559
青森県,0203,青森地域,いいえ,3312,3999,3742,3610,3727,3044,3518,24952,3370,4078,3814,3797,3683,3793,4940,27475
青森県,0204,西北五地域,はい,440,575,537,570,423,375,424,3344,223,281,319,289,252,261,288,1913
青森県,0204,西北五地域,いいえ,830,1021,1054,1099,1020,1141,1231,7396,874,1072,1208,1306,1469,1696,1889,9514
青森県,0205,上十三地域,はい,1130,1334,1139,1025,891,712,706,6937,558,730,621,527,457,434,532,3859
青森県,0205,上十三地域,いいえ,1844,2075,2023,1834,1894,1670,1695,13035,1608,1941,1964,1858,1946,2025,2223,13565
青森県,0206,下北地域,はい,342,376,364,338,288,238,225,2171,181,251,216,171,127,125,137,1208
青森県,0206,下北地域,いいえ,570,736,670,693,747,683,683,4782,561,709,746,683,787,835,879,5200
岩手県,0301,盛岡,はい,4188,4823,4311,3557,2882,2045,1915,23721,2088,2607,2365,1922,1366,1173,1389,12910
岩手県,0301,盛岡,いいえ,5397,6300,6034,5655,5749,4978,5662,39775,5328,6273,5987,5642,5917,6348,7698,43193
岩手県,0302,岩手中部,はい,2037,2265,1906,1668,1200,881,949,10906,893,1074,921,763,590,513,725,5479
岩手県,0302,岩手中部,いいえ,2592,2900,2605,2618,2615,2618,2686,18634,2293,2762,2643,2605,2672,3115,3576,19666
岩手県,0303,胆江,はい,1187,1269,983,931,788,653,646,6457,520,595,511,455,351,372,491,3295
岩手県,0303,胆江,いいえ,1463,1784,1559,1539,1717,1772,1844,11678,1418,1630,1483,1562,1822,2081,2488,12484
岩手県,0304,両磐,はい,882,977,823,782,666,564,550,5244,403,486,447,404,312,308,360,2720
岩手県,0304,両磐,いいえ,1275,1440,1341,1411,1542,1529,1637,10175,1176,1364,1327,1423,1610,1786,1885,10571
岩手県,0305,気仙,はい,278,372,386,354,296,255,249,2190,166,221,182,169,111,142,205,1196
岩手県,0305,気仙,いいえ,551,753,768,802,697,682,777,5030,510,656,745,810,794,933,1050,5498
岩手県,0306,釜石,はい,237,300,307,268,196,152,135,1595,124,145,147,116,83,71,92,778
岩手県,0306,釜石,いいえ,395,478,475,481,449,483,499,3260,342,418,423,456,500,540,732,3411
岩手県,0307,宮古,はい,434,488,560,462,374,325,359,3002,211,253,237,224,183,195,257,1560
岩手県,0307,宮古,いいえ,671,752,870,906,810,858,1101,5968,582,754,837,757,935,1107,1431,6403
岩手県,0308,久慈,はい,336,415,429,385,399,350,400,2714,213,251,277,207,235,242,310,1735
岩手県,0308,久慈,いいえ,508,606,620,545,664,579,665,4187,471,569,657,608,721,816,906,4748
岩手県,0309,二戸,はい,360,417,423,389,389,370,358,2706,210,228,262,233,249,260,327,1769
岩手県,0309,二戸,いいえ,458,549,581,659,647,738,769,4401,483,562,690,650,734,894,992,5005
宮城県,0401,仙南,はい,1200,1307,1096,931,824,734,708,6800,531,652,536,469,388,389,403,3368
宮城県,0401,仙南,いいえ,1962,2172,1999,1956,2181,2517,2776,15563,1796,2183,2061,2152,2411,2835,3088,16526
宮城県,0403,仙台,はい,14216,16399,14357,10391,7422,4947,4395,72127,6414,7506,6471,4680,3187,2336,2690,33284
宮城県,0403,仙台,いいえ,18679,22419,21080,18645,17434,16584,19193,134034,20289,23894,22300,19356,18632,19673,24670,148814
宮城県,0406,大崎・栗原,はい,2039,2116,1831,1566,1328,1112,1029,11021,833,1011,861,696,611,558,732,5302
宮城県,0406,大崎・栗原,いいえ,3245,3419,2900,3207,3707,3795,3886,24159,3079,3396,3216,3381,3839,4316,4227,25454
宮城県,0409,石巻・登米・気仙沼,はい,2093,2321,2132,1912,1624,1417,1538,13037,917,1101,999,866,729,667,988,6267
宮城県,0409,石巻・登米・気仙沼,いいえ,3840,4311,4046,3987,4288,4560,5176,30208,3563,4126,4206,4559,4954,5556,6356,33320
秋田県,0501,大館・鹿角,はい,446,524,506,519,438,339,362,3134,247,271,258,237,212,196,301,1722
秋田県,0501,大館・鹿角,いいえ,755,877,803,848,952,950,1135,6320,774,848,871,904,1045,1223,1558,7223
秋田県,0502,北秋田,はい,106,140,126,135,112,113,143,875,56,56,51,47,56,65,87,418
秋田県,0502,北秋田,いいえ,194,241,225,291,269,352,381,1953,159,217,229,247,301,412,519,2084
秋田県,0503,能代・山本,はい,323,365,361,361,343,252,279,2284,174,194,228,189,164,132,181,1262
秋田県,0503,能代・山本,いいえ,675,824,817,811,868,900,939,5834,662,822,899,913,1040,1154,1352,6842
秋田県,0504,秋田周辺,はい,1863,2177,2060,1804,1475,972,1034,11385,904,1076,961,684,545,514,611,5295
秋田県,0504,秋田周辺,いいえ,3259,4111,3798,3764,3637,3492,4096,26157,3258,3830,3883,3673,3949,4665,6057,29315
秋田県,0505,由利本荘・にかほ,はい,441,534,506,465,410,391,363,3110,255,278,279,268,212,234,228,1754
秋田県,0505,由利本荘・にかほ,いいえ,881,876,865,909,974,1099,1210,6814,826,952,993,999,1150,1435,1479,7834
秋田県,0506,大仙・仙北,はい,478,471,509,485,457,490,628,3518,260,251,235,228,213,327,430,1944
秋田県,0506,大仙・仙北,いいえ,875,1027,930,955,1144,1256,1479,7666,882,980,1021,1100,1451,1915,2046,9395
秋田県,0507,横手,はい,426,474,424,385,339,340,419,2807,225,234,224,204,176,226,278,1567
秋田県,0507,横手,いいえ,875,927,854,931,1040,1054,1161,6842,892,1063,1077,1084,1227,1504,1499,8346
秋田県,0508,湯沢・雄勝,はい,278,265,244,254,267,233,256,1797,121,127,153,116,119,133,144,913
秋田県,0508,湯沢・雄勝,いいえ,477,541,606,654,716,847,904,4745,422,548,606,646,791,1002,1102,5117
山形県,0601,村山,はい,4010,4393,3843,3195,2497,1653,1349,20940,1988,2076,1886,1490,1091,727,640,9898
山形県,0601,村山,いいえ,7592,8006,7416,7254,7723,7866,8536,54393,7749,8611,7964,7976,8429,8680,8864,58273
山形県,0602,最上,はい,425,493,403,418,352,294,225,2610,202,243,231,200,151,132,127,1286
山形県,0602,最上,いいえ,962,1056,970,1081,1304,1315,1383,8071,948,1088,1133,1202,1485,1534,1425,8815
山形県,0603,置賜,はい,1464,1558,1481,1304,1147,769,689,8412,698,750,711,625,482,358,323,3947
山形県,0603,置賜,いいえ,3019,3409,3156,3088,3174,3319,3489,22654,2925,3338,3263,3311,3423,3643,3681,23584
山形県,0604,庄内,はい,1940,2060,1941,1662,1383,961,823,10770,1006,1092,976,835,640,454,480,5483
山形県,0604,庄内,いいえ,3687,4242,3955,3979,4404,4590,4968,29825,3814,4426,4417,4514,4916,5416,5912,33415
福島県,0701,県北,はい,3521,4077,3642,3188,2411,1752,1834,20425,1611,1954,1822,1575,1114,920,1065,10061
福島県,0701,県北,いいえ,5430,6430,6148,5930,6278,6103,6889,43208,5596,6587,6570,6228,6674,7183,8243,47081
福島県,0702,県中,はい,3905,4244,3591,3031,2343,1688,1480,20282,1799,1992,1856,1577,1206,945,1028,10403
福島県,0702,県中,いいえ,5540,6428,5804,5573,5951,5467,5903,40666,5797,6659,6147,6160,6406,6478,7343,44990
福島県,0703,県南,はい,1201,1188,954,968,736,574,572,6193,532,539,484,410,383,289,342,2979
福島県,0703,県南,いいえ,1729,1957,1764,1798,1909,1998,2046,13201,1683,1943,1705,1736,2141,2307,2402,13917
福島県,0706,相双,はい,720,819,656,645,588,537,662,4627,309,389,340,316,280,301,427,2362
福島県,0706,相双,いいえ,1424,1678,1516,1515,1844,2341,2635,12953,1338,1522,1560,1660,2282,2817,3136,14315
福島県,0707,いわき,はい,2082,2459,2318,1810,1372,913,735,11689,993,1172,1047,834,660,407,350,5463
福島県,0707,いわき,いいえ,3554,4260,3973,3764,3590,3256,3388,25785,3241,3930,3825,3720,3711,3462,4022,25911
福島県,0708,会津・南会津,はい,1596,1761,1599,1478,1244,993,949,9620,802,948,917,821,614,519,592,5213
福島県,0708,会津・南会津,いいえ,2847,3195,2967,3310,3599,3653,4022,23593,2758,3220,3225,3513,3935,4456,4810,25917
茨城県,0801,水戸,はい,3737,4414,3924,3099,2001,1127,839,19141,1489,1832,1755,1317,810,584,598,8385
茨城県,0801,水戸,いいえ,4570,5593,5461,4684,4331,3363,2931,30933,4614,5536,5389,4811,4107,3511,3341,31309
茨城県,0802,日立,はい,1231,1594,1511,1250,871,566,590,7613,565,707,719,533,388,345,526,3783
茨城県,0802,日立,いいえ,2311,2861,2951,2647,2506,2246,2517,18039,2226,3093,3370,2825,2565,2590,3096,19765
茨城県,0803,常陸太田・ひたちなか,はい,2658,3184,3133,2526,1557,1078,1087,15223,934,1247,1249,918,649,599,821,6417
茨城県,0803,常陸太田・ひたちなか,いいえ,3732,4607,4768,4307,3974,3655,3907,28950,3569,4320,4650,4074,3990,4232,4618,29453
茨城県,0804,鹿行,はい,1963,2445,2058,1526,1098,752,581,10423,728,933,848,621,420,309,425,4284
茨城県,0804,鹿行,いいえ,2706,3191,2961,2505,2198,1947,1792,17300,2446,2813,2822,2413,2338,2152,2185,17169
茨城県,0805,土浦,はい,2006,2436,2295,1753,1139,815,688,11132,790,1027,944,743,501,377,438,4820
茨城県,0805,土浦,いいえ,2596,3205,3046,2722,2403,2419,2586,18977,2314,3081,3040,2662,2635,2680,3251,19663
茨城県,0806,つくば,はい,3135,3386,2818,1929,1300,798,840,14206,1312,1502,1214,877,547,419,568,6439
茨城県,0806,つくば,いいえ,4462,4770,4220,3579,2994,2649,2971,25645,4284,4854,4247,3422,3038,3138,3484,26467
茨城県,0807,取手・竜ヶ崎,はい,3565,4475,3969,2893,1875,1308,1307,19392,1521,1860,1664,1238,803,665,737,8488
茨城県,0807,取手・竜ヶ崎,いいえ,4637,5901,5679,4937,4452,4428,5539,35573,4566,5782,5607,4905,4722,5160,6504,37246
茨城県,0808,筑西・下妻,はい,1844,2209,2001,1503,1124,958,877,10516,751,942,912,674,519,569,656,5023
茨城県,0808,筑西・下妻,いいえ,2491,2943,2643,2468,2560,2522,2290,17917,2379,2941,2937,2753,2807,2974,2783,19574
茨城県,0809,古河・坂東,はい,1692,1898,1864,1367,1055,585,476,8937,635,775,819,553,404,293,313,3792
茨城県,0809,古河・坂東,いいえ,2126,2518,2454,2095,1962,1501,1182,13838,1861,2445,2354,1992,1923,1618,1385,13578
栃木県,0901,県北,はい,2988,3281,2837,2241,1738,1411,1297,15793,1122,1361,1252,951,769,639,721,6815
栃木県,0901,県北,いいえ,4701,5245,4870,4348,4599,4812,5289,33864,4188,4921,4731,4421,4851,5527,6019,34658
栃木県,0902,県西,はい,1224,1531,1413,1099,841,637,649,7394,498,692,550,494,346,308,343,3231
栃木県,0902,県西,いいえ,1764,2287,2297,2089,2203,2119,2279,15038,1713,2155,2305,2097,2209,2424,2865,15768
栃木県,0903,宇都宮,はい,5061,5667,4966,3487,2172,1259,1055,23667,1855,2189,1997,1374,783,510,640,9348
栃木県,0903,宇都宮,いいえ,7216,8270,7965,6839,5668,4209,4458,44625,6567,7658,7171,5868,5023,4666,5477,42430
栃木県,0904,県東,はい,1310,1419,1201,954,753,615,575,6827,482,563,441,406,305,290,279,2766
栃木県,0904,県東,いいえ,1923,2195,1888,1812,1898,2104,2223,14043,1608,1930,1859,1699,2064,2424,2609,14193
栃木県,0905,県南,はい,3916,4884,4086,3122,2199,1555,1373,21135,1517,1840,1776,1253,919,677,774,8756
栃木県,0905,県南,いいえ,5153,6558,6068,5374,5375,5241,5612,39381,5096,6140,6174,5264,5451,5942,6600,40667
栃木県,0906,両毛,はい,1823,2298,2109,1679,1144,758,800,10611,725,832,864,685,452,387,526,4471
栃木県,0906,両毛,いいえ,2735,3311,3301,2883,2648,2496,2788,20162,2217,3002,2990,2705,2638,2936,3600,20088
群馬県,1001,前橋,はい,2706,3270,2957,2262,1591,1113,1049,14948,1118,1338,1328,1069,692,587,733,6865
群馬県,1001,前橋,いいえ,3942,4684,4561,4013,3824,3674,4208,28906,3529,4674,4639,4254,3967,4416,5588,31067
群馬県,1002,渋川,はい,827,915,842,666,611,425,372,4658,322,407,385,309,229,190,250,2092
群馬県,1002,渋川,いいえ,1173,1387,1292,1182,1327,1274,1437,9072,1120,1312,1398,1189,1289,1482,1786,9576
群馬県,1003,伊勢崎,はい,2088,2536,2348,1815,1233,768,749,11537,910,1010,1044,764,474,390,485,5077
群馬県,1003,伊勢崎,いいえ,2861,3503,3368,2958,2762,2506,2972,20930,2631,3423,3405,2848,2680,3048,4110,22145
群馬県,1004,高崎・安中,はい,3371,4223,3941,2822,1878,1221,1079,18535,1318,1666,1617,1233,797,541,712,7884
群馬県,1004,高崎・安中,いいえ,4619,5839,5900,5162,4526,4171,4968,35185,4364,5862,5942,5098,4478,5091,6738,37573
群馬県,1005,藤岡,はい,441,598,520,469,319,204,237,2788,178,240,233,200,160,117,123,1251
群馬県,1005,藤岡,いいえ,631,862,820,702,717,733,955,5420,521,787,840,741,734,876,1244,5743
群馬県,1006,富岡,はい,402,508,459,439,326,274,286,2694,159,228,227,175,139,144,194,1266
群馬県,1006,富岡,いいえ,659,842,819,823,891,988,1109,6131,632,875,896,897,959,1162,1394,6815
群馬県,1007,吾妻,はい,235,321,337,315,310,221,259,1998,100,151,183,162,116,120,146,978
群馬県,1007,吾妻,いいえ,450,624,639,622,719,802,916,4772,426,569,626,649,758,812,1064,4904
群馬県,1008,沼田,はい,394,553,528,442,412,319,372,3020,215,270,253,233,208,186,219,1584
群馬県,1008,沼田,いいえ,723,872,941,972,1016,1190,1275,6989,688,971,951,1036,1159,1345,1556,7706
群馬県,1009,桐生,はい,995,1300,1234,972,700,502,566,6269,399,569,584,437,304,266,385,2944
群馬県,1009,桐生,いいえ,1541,2010,2111,1791,1734,1609,2288,13084,1393,1945,2104,1771,1798,2125,3066,14202
群馬県,1010,太田・館林,はい,3551,4007,3600,2631,1556,1099,1325,17769,1127,1386,1325,925,596,583,852,6794
群馬県,1010,太田・館林,いいえ,4785,5654,5364,4433,3717,3739,4955,32647,3739,5103,4828,3938,3817,4677,6533,32635
埼玉県,1101,南部,はい,7513,8573,8191,5589,3373,1829,1650,36718,2818,3471,3221,2367,1359,854,1016,15106
埼玉県,1101,南部,いいえ,9144,10932,10765,8917,6765,5579,6585,58687,8703,10563,10550,8463,6634,5877,8729,59519
埼玉県,1102,南西部,はい,6846,8105,7518,5436,3052,1793,1861,34611,2802,3283,3083,2270,1278,825,1299,14840
埼玉県,1102,南西部,いいえ,8260,9717,9860,8247,6408,5587,7295,55374,8466,10379,10512,8428,6384,6542,10037,60748
埼玉県,1103,東部,はい,9845,12094,11272,7833,4661,3075,3252,52032,4113,5132,4873,3426,2158,1588,2266,23556
埼玉県,1103,東部,いいえ,11056,14388,14007,11126,9145,8715,12382,80819,11707,14892,14930,11755,9849,11392,18020,92545
埼玉県,1104,さいたま,はい,12449,14448,13407,9596,5639,2845,2381,60765,4756,5552,5149,3716,2077,1084,1297,23631
埼玉県,1104,さいたま,いいえ,15096,17856,18140,15589,13286,10523,12586,103076,15120,17957,18479,15244,12126,11321,15584,105831
埼玉県,1105,県央,はい,4549,5654,5322,3854,2355,1558,1581,24873,1689,2209,2095,1566,913,754,1177,10403
埼玉県,1105,県央,いいえ,5422,7000,7150,6012,5497,5253,7024,43358,5085,6792,7281,5919,5353,6187,9490,46107
埼玉県,1106,川越比企,はい,6626,8160,7401,5300,3538,2303,2295,35623,2537,3084,3012,2153,1408,1065,1315,14574
埼玉県,1106,川越比企,いいえ,8382,10435,10336,8602,7920,7641,10030,63346,7492,9670,9674,8197,7947,8918,12569,64467
埼玉県,1107,西部,はい,5861,7774,7251,5375,3496,2140,1961,33858,2490,3295,2995,2180,1474,974,1213,14621
埼玉県,1107,西部,いいえ,7491,9475,9846,8565,7777,7198,9170,59522,7518,9351,9781,8527,7466,7949,10989,61581
埼玉県,1108,利根,はい,4814,6063,5344,3959,2854,1922,1869,26825,1847,2222,2101,1596,1058,846,1263,10933
埼玉県,1108,利根,いいえ,5842,7590,7415,6281,6334,6652,8213,48327,5502,7114,7090,6376,6494,7757,10594,50927
埼玉県,1109,北部,はい,3841,4557,4194,3237,2211,1524,1359,20923,1587,1882,1752,1311,953,677,806,8968
埼玉県,1109,北部,いいえ,5341,6338,6251,5457,5278,5073,5451,39189,4853,6262,6316,5727,5446,5577,6438,40619
埼玉県,1110,秩父,はい,508,602,621,543,424,329,306,3333,184,289,269,225,185,161,202,1515
埼玉県,1110,秩父,いいえ,777,956,1079,1003,1117,1189,1280,7401,743,998,1067,1041,1130,1325,1440,7744
千葉県,1201,千葉,はい,8259,10695,10303,7176,4272,2279,2030,45014,3362,4230,4264,2953,1720,1115,1392,19036
千葉県,1201,千葉,いいえ,9870,12718,13814,11332,9181,7045,9069,73029,9680,12692,13517,10679,8421,8006,12196,75191
千葉県,1202,東葛南部,はい,16385,19634,18614,12775,7106,3645,2889,81048,6749,7892,7481,5170,2837,1555,1739,33423
千葉県,1202,東葛南部,いいえ,19446,23742,24496,20057,14811,10507,11774,124833,20091,24893,25115,19218,13870,11461,15006,129654
千葉県,1203,東葛北部,はい,12386,14961,13654,9332,5620,3382,3060,62395,5181,6099,5591,3915,2439,1702,2148,27075
千葉県,1203,東葛北部,いいえ,15039,17720,17601,14631,12353,10854,14142,102340,15241,18450,18285,15020,12345,13103,18904,111348
千葉県,1204,印旛,はい,5570,6644,6144,4404,3071,2072,1770,29675,2300,2755,2610,1803,1365,861,959,12653
千葉県,1204,印旛,いいえ,6634,7959,7724,6587,6682,7170,8582,51338,6990,8588,8265,7244,7238,8209,9715,56249
千葉県,1205,香取海匝,はい,1431,1797,1683,1468,1205,954,1055,9593,560,717,751,639,577,531,669,4444
千葉県,1205,香取海匝,いいえ,1958,2450,2586,2366,2705,3036,3682,18783,1912,2336,2675,2715,3264,3974,4773,21649
千葉県,1206,山武長生夷隅,はい,2468,3212,3120,2508,1973,1458,1519,16258,1068,1352,1423,1155,884,734,800,7416
千葉県,1206,山武長生夷隅,いいえ,3388,4214,4210,4022,4384,4928,5830,30976,3214,4058,4413,4343,4814,5468,6526,32836
千葉県,1207,安房,はい,530,703,686,513,416,339,342,3529,275,381,374,264,187,141,167,1789
千葉県,1207,安房,いいえ,819,1028,1135,989,1081,1043,1204,7299,886,1145,1154,1024,1122,1315,1653,8299
千葉県,1208,君津,はい,2557,3149,2900,2146,1606,1206,1174,14738,967,1224,1172,857,552,510,782,6064
千葉県,1208,君津,いいえ,3195,3890,3612,3123,3223,3725,4658,25426,2836,3462,3504,3109,3175,4233,5781,26100
千葉県,1209,市原,はい,1759,2252,2122,1521,1138,890,791,10473,749,933,914,707,484,395,482,4664
千葉県,1209,市原,いいえ,2244,2969,2885,2455,2386,2965,3545,19449,2250,2932,2952,2526,2724,3454,4389,21227
東京都,1301,区中央部,はい,14700,16059,14705,10739,5585,2239,1652,65679,7157,7674,6631,4423,2338,1136,1112,30471
東京都,1301,区中央部,いいえ,22488,24880,24004,20469,14641,7656,6855,120993,19970,21544,19933,14689,10082,6961,8861,102040
東京都,1302,区南部,はい,11365,12898,12114,8199,4866,2452,2285,54179,5785,6431,5807,3868,2164,1222,1514,26791
東京都,1302,区南部,いいえ,16914,18987,19456,15850,11362,7962,9549,100080,17304,19542,18296,13800,10235,9266,12909,101352
東京都,1303,区西南部,はい,11500,12098,10450,7783,4419,2365,1995,50610,7419,7624,6731,4730,2622,1417,1621,32164
東京都,1303,区西南部,いいえ,17451,18748,18311,16692,12695,8872,10493,103262,21091,23729,22350,17904,13666,11406,15443,125589
東京都,1304,区西部,はい,11631,11904,10714,7666,4473,2428,2166,50982,6834,7091,6225,4548,2509,1348,1506,30061
東京都,1304,区西部,いいえ,16587,17588,16614,14688,11449,8589,9851,95366,18342,20216,19392,15917,12661,10532,14103,111163
東京都,1305,区西北部,はい,17434,18665,17249,12629,8229,4694,4252,83152,8743,9819,9093,6989,4326,2774,2927,44671
東京都,1305,区西北部,いいえ,23503,25755,25004,21767,18115,14648,17581,146373,25199,28828,28870,24132,20447,18756,25442,171674
東京都,1306,区東北部,はい,10764,12983,12000,8853,5702,3771,3821,57894,4986,6145,6084,4527,2923,2014,2662,29341
東京都,1306,区東北部,いいえ,14175,16884,16803,13984,11468,10219,13666,97199,15260,18070,18421,15841,13030,13122,19056,112800
東京都,1307,区東部,はい,14431,17032,16532,11352,6428,3507,3150,72432,6720,7800,7394,5079,2916,1722,2049,33680
東京都,1307,区東部,いいえ,19768,23158,23582,19115,13237,9673,11395,119928,20300,23661,23551,17216,12520,11316,16168,124732
東京都,1308,西多摩,はい,2436,3139,3337,2462,1643,1171,1251,15439,1027,1347,1425,1109,672,545,812,6937
東京都,1308,西多摩,いいえ,3665,4674,5216,4545,4075,4304,6256,32735,3649,4880,5344,4693,4488,5305,7977,36336
東京都,1309,南多摩,はい,11467,14234,14246,10391,5963,3672,3773,63746,5015,6093,5971,4426,2848,1817,2550,28720
東京都,1309,南多摩,いいえ,14946,18379,20259,17716,14289,12926,18424,116939,15820,20182,21531,17845,15116,16554,25073,132121
東京都,1310,北多摩西部,はい,5375,6344,6114,4689,2796,1638,1609,28565,2291,2634,2641,1940,1195,786,1029,12516
東京都,1310,北多摩西部,いいえ,7183,8569,8851,8258,6654,5688,7649,52852,7169,8745,9146,7975,6640,6902,10488,57065
東京都,1311,北多摩南部,はい,9235,9835,9478,7174,4127,2227,2173,44249,4477,4737,4634,3346,2015,1163,1386,21758
東京都,1311,北多摩南部,いいえ,13130,14564,15035,13810,10738,8802,11448,87527,14548,16707,16885,14150,11496,10964,15304,100054
東京都,1312,北多摩北部,はい,5960,6948,6835,5253,3197,1922,1845,31960,2712,3027,3093,2433,1471,943,1262,14941
東京都,1312,北多摩北部,いいえ,8114,9388,9734,9163,7753,6679,8869,59700,8696,10522,11164,9875,8495,8513,12222,69487
東京都,1313,島しょ,はい,114,130,132,125,85,91,83,760,66,78,68,41,57,39,55,404
東京都,1313,島しょ,いいえ,245,289,291,266,231,254,322,1898,273,285,295,221,249,308,364,1995
神奈川県,1404,川崎北部,はい,7946,8948,8592,6392,3349,1526,1323,38076,3419,3899,3779,2672,1495,746,857,16867
神奈川県,1404,川崎北部,いいえ,10435,11955,12705,11179,7863,5604,5986,65727,10988,12706,13090,10393,7490,5828,7397,67892
神奈川県,1405,川崎南部,はい,6936,8000,6988,4739,2557,1367,970,31557,2952,3142,2785,1894,1018,530,535,12856
神奈川県,1405,川崎南部,いいえ,9964,11249,10534,8250,6028,3941,3898,53864,9196,9955,9223,6926,4876,3740,4475,48391
神奈川県,1406,横須賀・三浦,はい,4330,6047,6172,4755,3048,1756,1505,27613,2050,2742,2897,2033,1230,806,924,12682
神奈川県,1406,横須賀・三浦,いいえ,5913,8197,9058,8144,7143,5694,7233,51382,6243,8508,9254,7696,6450,6351,8954,53456
神奈川県,1407,湘南東部,はい,6321,7888,7450,5476,2987,1439,1398,32959,2609,3143,2897,1999,1100,634,904,13286
神奈川県,1407,湘南東部,いいえ,8000,9723,10460,9143,7276,5537,7813,57952,8239,10277,10441,8431,6743,6730,10970,61831
神奈川県,1408,湘南西部,はい,4318,5363,5062,3754,2304,1296,1263,23360,1596,2124,1992,1473,928,602,894,9609
神奈川県,1408,湘南西部,いいえ,5626,6970,7499,6835,5786,5169,7176,45061,5426,6961,7181,6084,5281,5783,8786,45502
神奈川県,1409,県央,はい,7678,9422,8878,6462,3570,1941,2006,39957,2807,3641,3517,2351,1450,902,1347,16015
神奈川県,1409,県央,いいえ,9125,11269,11879,10079,8195,6477,8936,65960,8180,10683,10803,8798,7122,7429,12249,65264
神奈川県,1410,相模原,はい,6208,7388,7156,5115,3076,1609,1405,31957,2526,2995,2944,2095,1235,710,845,13350
神奈川県,1410,相模原,いいえ,7292,9021,9426,8349,6491,5137,6249,51965,6888,8683,9008,7603,5996,5457,7880,51515
神奈川県,1411,県西,はい,2604,3074,2979,2301,1303,655,670,13586,906,1099,1086,750,497,310,492,5140
神奈川県,1411,県西,いいえ,3499,4475,4843,4595,3743,2888,3741,27784,2984,3971,4229,3503,3118,3280,4734,25819
神奈川県,1412,横浜,はい,32953,39772,39580,28507,16225,7807,6036,170880,13998,16772,16488,11696,6533,3254,3248,71989
神奈川県,1412,横浜,いいえ,42478,51975,56121,49759,38304,27325,29495,295457,42636,53065,56322,45080,33761,27244,33774,291882
新潟県,1501,下越,はい,1464,1666,1642,1463,1112,827,782,8956,668,849,750,644,439,346,437,4133
新潟県,1501,下越,いいえ,2426,2753,2728,2644,2752,2927,3499,19729,2336,2810,2959,2803,3023,3564,4166,21661
新潟県,1502,新潟,はい,7529,9052,8112,6505,4504,2802,2465,40969,3324,3943,3553,2743,1783,1219,1432,17997
新潟県,1502,新潟,いいえ,11221,13493,12387,10923,10346,9797,11138,79305,10694,13260,12307,11307,10679,11202,14289,83738
新潟県,1503,県央,はい,1565,1977,1786,1506,1134,758,716,9442,694,911,799,613,424,333,406,4180
新潟県,1503,県央,いいえ,2917,3396,3366,2993,2877,2806,2945,21300,2618,3328,3373,3163,2984,3199,3469,22134
新潟県,1504,中越,はい,3340,3868,3545,2861,2145,1392,1274,18425,1536,1804,1578,1190,824,610,854,8396
新潟県,1504,中越,いいえ,5952,6864,6384,6000,5878,5439,6547,43064,5773,7105,6754,6380,6276,6575,8080,46943
新潟県,1505,魚沼,はい,992,1082,981,894,820,745,733,6247,492,608,519,443,368,338,356,3124
新潟県,1505,魚沼,いいえ,2113,2399,2260,2214,2486,2726,3065,17263,2034,2303,2344,2280,2442,2932,3104,17439
新潟県,1506,上越,はい,1682,2054,1874,1620,1258,908,922,10318,743,964,798,677,476,390,502,4550
新潟県,1506,上越,いいえ,3702,4346,4115,3857,3924,3677,4058,27679,3277,4198,4035,3791,3723,3867,4539,27430
新潟県,1507,佐渡,はい,270,336,346,282,265,245,246,1990,147,208,159,171,133,115,119,1052
新潟県,1507,佐渡,いいえ,637,648,724,768,847,834,1058,5516,566,621,672,660,849,915,1168,5451
富山県,1601,新川,はい,794,1115,1002,835,673,409,375,5203,351,523,459,410,219,210,273,2445
富山県,1601,新川,いいえ,1607,1964,1919,1569,1518,1420,1659,11656,1469,1948,1947,1768,1611,1698,2478,12919
富山県,1602,富山,はい,3940,5134,4610,3376,2304,1503,1299,22166,1657,2168,1969,1477,982,670,910,9833
富山県,1602,富山,いいえ,6837,8572,8193,6658,5790,4710,5277,46037,6349,8161,7911,6600,5711,5369,6823,46924
富山県,1603,高岡,はい,2328,2898,2555,1994,1430,1078,1372,13655,922,1220,1176,889,656,598,1090,6551
富山県,1603,高岡,いいえ,4061,5417,4985,4174,3697,3524,4724,30582,3518,4904,4901,4104,3949,4437,6697,32510
富山県,1604,砺波,はい,858,1042,913,789,584,526,737,5449,421,542,426,358,304,328,614,2993
富山県,1604,砺波,いいえ,1473,1904,1690,1508,1656,1527,2069,11827,1393,1815,1813,1721,1827,2141,2779,13489
石川県,1701,南加賀,はい,1483,2074,1756,1362,982,635,752,9044,742,1071,935,713,554,423,585,5023
石川県,1701,南加賀,いいえ,2793,3618,3167,2726,2358,2057,2741,19460,2616,3373,3314,2952,2599,2613,3756,21223
石川県,1702,石川中央,はい,5308,6715,5962,4313,2966,1992,2064,29320,2411,3137,2881,2177,1440,988,1364,14398
石川県,1702,石川中央,いいえ,9219,11299,10473,8555,7461,6024,7354,60385,8885,11146,10440,8603,7783,7438,10251,64546
石川県,1703,能登中部,はい,546,724,631,562,476,405,566,3910,285,362,353,346,276,292,428,2342
石川県,1703,能登中部,いいえ,1096,1451,1342,1215,1205,1292,1751,9352,980,1442,1323,1302,1389,1781,2442,10659
石川県,1704,能登北部,はい,206,276,272,298,303,270,381,2006,127,170,179,158,165,179,301,1279
石川県,1704,能登北部,いいえ,434,626,581,609,661,776,1043,4730,435,543,602,636,745,947,1355,5263
福井県,1801,福井・坂井,はい,2871,3507,3141,2485,1779,967,668,15418,1182,1505,1451,1151,738,425,340,6792
福井県,1801,福井・坂井,いいえ,4890,5819,5474,4815,4331,3015,2532,30876,4438,5579,5433,4714,3952,2691,2341,29148
福井県,1802,奥越,はい,335,398,343,293,233,161,160,1923,150,187,196,142,118,87,90,970
福井県,1802,奥越,いいえ,664,764,700,684,733,740,712,4997,686,760,759,833,810,834,863,5545
福井県,1803,丹南,はい,1467,1700,1397,1106,733,427,335,7165,619,677,589,450,326,196,243,3100
福井県,1803,丹南,いいえ,2437,2804,2536,2237,1992,1459,1498,14963,2229,2682,2656,2323,2044,1626,1856,15416
福井県,1804,嶺南,はい,813,964,846,709,525,318,300,4475,290,392,313,267,161,154,181,1758
福井県,1804,嶺南,いいえ,1576,1817,1796,1693,1706,1508,1565,11661,1277,1701,1647,1541,1475,1568,1903,11112
山梨県,1901,中北,はい,3599,4199,3939,3093,1967,1188,830,18815,1659,2016,1930,1484,921,557,464,9031
山梨県,1901,中北,いいえ,5537,6728,6731,6221,5635,5645,6324,42821,5599,7203,7119,6626,6414,6751,7812,47524
山梨県,1902,峡東,はい,909,1088,1151,836,590,391,367,5332,477,588,573,439,257,199,196,2729
山梨県,1902,峡東,いいえ,1425,1862,1905,1762,1792,1781,2028,12555,1527,1945,2125,1991,1962,2137,2286,13973
山梨県,1903,峡南,はい,311,356,382,321,260,185,149,1964,119,191,190,165,105,82,88,940
山梨県,1903,峡南,いいえ,502,627,666,724,837,939,1103,5398,510,671,751,827,911,1059,1269,5998
山梨県,1904,富士・東部,はい,1099,1291,1406,1221,888,592,497,6994,500,550,629,488,357,271,238,3033
山梨県,1904,富士・東部,いいえ,1823,2171,2457,2560,2394,2212,2272,15889,1753,2273,2630,2673,2559,2442,2545,16875
長野県,2001,佐久,はい,1457,1560,1532,1263,935,630,588,7965,659,734,694,614,406,283,317,3707
長野県,2001,佐久,いいえ,2433,2806,2706,2590,2603,2508,2940,18586,2382,2751,2851,2677,2728,2863,3405,19657
長野県,2002,上小,はい,1344,1700,1506,1183,800,502,444,7479,603,699,649,540,398,258,322,3469
長野県,2002,上小,いいえ,2100,2710,2601,2317,2158,2093,2323,16302,1952,2623,2676,2416,2349,2370,2910,17296
長野県,2003,諏訪,はい,1426,1790,1777,1191,834,525,509,8052,585,876,775,594,372,287,320,3809
長野県,2003,諏訪,いいえ,2226,2884,2746,2431,2102,2044,2639,17072,2205,3010,2994,2493,2411,2399,3413,18925
長野県,2004,上伊那,はい,1486,1837,1598,1181,868,585,579,8134,589,775,675,542,403,317,362,3663
長野県,2004,上伊那,いいえ,2353,2994,2802,2527,2493,2217,2694,18080,2393,3072,3049,2699,2565,2599,3391,19768
長野県,2005,飯伊,はい,1244,1362,1344,1076,688,565,438,6717,542,630,578,472,347,251,270,3090
長野県,2005,飯伊,いいえ,1908,2271,2218,2104,2030,2013,2120,14664,1883,2346,2329,2301,2318,2295,2354,15826
長野県,2006,木曽,はい,135,172,153,156,115,100,118,949,63,59,61,68,48,34,44,377
長野県,2006,木曽,いいえ,264,354,377,436,384,488,619,2922,256,278,333,362,422,486,713,2850
長野県,2007,松本,はい,3511,4264,3919,2890,1801,1141,957,18483,1458,1837,1771,1236,863,538,587,8290
長野県,2007,松本,いいえ,5086,6349,6202,5306,4450,3604,3610,34607,4685,6149,6094,5320,4531,3852,4219,34850
長野県,2008,大北,はい,357,435,456,390,270,217,197,2322,176,213,224,201,134,100,128,1176
長野県,2008,大北,いいえ,643,855,828,797,760,730,969,5582,557,837,854,845,810,789,1036,5728
長野県,2009,長野,はい,4575,5390,5044,3738,2512,1592,1614,24465,1853,2322,2222,1666,1148,820,920,10951
長野県,2009,長野,いいえ,6339,8013,8020,7199,6672,5957,7169,49369,6180,8274,8355,7587,6751,7181,9628,53956
長野県,2010,北信,はい,549,655,640,578,417,366,363,3568,273,330,284,279,200,153,217,1736
長野県,2010,北信,いいえ,971,1144,1121,1132,1174,1142,1330,8014,1008,1288,1264,1312,1329,1344,1418,8963
岐阜県,2101,岐阜,はい,5304,6470,5807,3976,2440,1294,1055,26346,1913,2353,2323,1717,1038,652,794,10790
岐阜県,2101,岐阜,いいえ,9217,11608,11524,9840,8109,6152,6499,62949,8204,10800,10953,8946,7334,6076,7304,59617
岐阜県,2102,西濃,はい,2386,2908,2628,1956,1276,788,805,12747,865,1036,967,823,525,410,614,5240
岐阜県,2102,西濃,いいえ,4410,5586,5431,4787,4448,4028,4660,33350,3738,4960,4991,4501,4391,4425,5741,32747
岐阜県,2103,中濃,はい,2459,2916,2553,1912,1242,849,820,12751,833,1043,964,723,527,388,490,4968
岐阜県,2103,中濃,いいえ,4549,5618,5318,4622,4798,4574,5274,34753,3833,4966,5080,4784,4803,4949,5656,34071
岐阜県,2104,東濃,はい,2383,2832,2578,1982,1334,789,683,12581,778,999,973,829,555,376,446,4956
岐阜県,2104,東濃,いいえ,3908,4984,4943,4671,4295,3987,4405,31193,3529,4610,4868,4524,4533,4321,5499,31884
岐阜県,2105,飛騨,はい,853,1012,883,750,564,474,553,5089,343,486,470,376,326,292,386,2679
岐阜県,2105,飛騨,いいえ,1867,2378,2377,2160,2089,1878,2571,15320,1763,2282,2355,2246,2132,2305,3039,16122
静岡県,2201,賀茂,はい,235,335,387,321,224,157,171,1830,102,160,166,132,103,82,92,837
静岡県,2201,賀茂,いいえ,428,582,696,627,617,675,817,4442,388,568,639,583,617,780,1095,4670
静岡県,2202,熱海伊東,はい,399,596,633,497,388,282,364,3159,199,292,346,261,224,172,242,1736
静岡県,2202,熱海伊東,いいえ,534,864,992,957,1038,1046,1667,7098,650,936,1119,1081,1130,1390,2528,8834
静岡県,2203,駿東田方,はい,5079,6105,5732,4307,2631,1563,1415,26832,1865,2351,2282,1753,1133,726,830,10940
静岡県,2203,駿東田方,いいえ,7275,9176,9441,8513,7679,7081,8738,57903,6865,9038,9284,8266,7654,8252,11450,60809
静岡県,2204,富士,はい,3226,3913,3671,2649,1674,929,758,16820,1113,1444,1358,994,631,335,375,6250
静岡県,2204,富士,いいえ,4734,5661,5862,5287,4647,3986,4550,34727,4013,5235,5598,5021,4435,4426,5419,34147
静岡県,2205,静岡,はい,5182,6631,6355,4589,2903,1669,1422,28751,1986,2490,2463,1885,1107,608,703,11242
静岡県,2205,静岡,いいえ,8063,10373,10754,9409,8631,7196,8387,62813,8158,10422,10978,9334,8292,7605,9400,64189
静岡県,2206,志太榛原,はい,3346,3990,3660,2709,1762,980,743,17190,1224,1480,1417,1072,671,334,308,6506
静岡県,2206,志太榛原,いいえ,5510,6703,6350,5794,5703,4754,5188,40002,5351,6582,6339,5737,5549,5033,5923,40514
静岡県,2207,中東遠,はい,4010,4376,3586,2675,1750,960,718,18075,1269,1554,1287,922,572,318,335,6257
静岡県,2207,中東遠,いいえ,6805,7838,7068,6302,6318,5470,5995,45796,6251,7272,6788,6004,6311,6069,6729,45424
静岡県,2208,西部,はい,6907,7777,7117,5224,3224,1708,1528,33485,2384,2913,2795,1936,1337,768,883,13016
静岡県,2208,西部,いいえ,11929,14181,14218,12544,11309,9015,9880,83076,10978,13573,13940,11548,10431,9415,10957,80842
愛知県,2302,海部,はい,2272,3178,3016,2056,1186,761,759,13228,708,1064,986,680,441,344,682,4905
愛知県,2302,海部,いいえ,3478,4755,4863,3930,3169,2755,3911,26861,3093,4338,4449,3602,3185,3353,5433,27453
愛知県,2304,尾張東部,はい,4524,5173,4623,3144,1822,917,949,21152,1305,1640,1545,1078,597,444,606,7215
愛知県,2304,尾張東部,いいえ,5923,7349,7572,6100,5039,4012,5553,41548,6090,7307,7322,5726,4811,4853,7407,43516
愛知県,2305,尾張西部,はい,3756,4860,4579,3299,1933,1086,1323,20836,1229,1699,1619,1245,819,595,993,8199
愛知県,2305,尾張西部,いいえ,5344,7231,7382,6313,5116,4933,6761,43080,5531,7431,7717,6432,5608,6096,9339,48154
愛知県,2306,尾張北部,はい,5431,6929,6353,4319,2529,1400,1339,28300,1736,2211,2296,1494,909,665,989,10300
愛知県,2306,尾張北部,いいえ,8137,10602,10652,8616,6769,5943,7887,58606,7420,10103,10026,7831,6446,6950,10474,59250
愛知県,2307,知多半島,はい,5863,6986,6125,4337,2607,1506,1455,28879,1849,2262,2055,1538,919,681,1013,10317
愛知県,2307,知多半島,いいえ,8215,10403,9881,8598,7044,6273,8724,59138,7665,9665,9589,7851,7047,7482,11096,60395
愛知県,2308,西三河北部,はい,5451,6009,5473,4052,2255,932,819,24991,1422,1755,1545,1090,612,417,560,7401
愛知県,2308,西三河北部,いいえ,7016,8071,8373,7050,5850,4186,5449,45995,6158,7598,7699,5847,4850,4823,6500,43475
愛知県,2309,西三河南部西,はい,7371,8253,7207,5098,2874,1341,1305,33449,2095,2329,2233,1584,898,583,856,10578
愛知県,2309,西三河南部西,いいえ,10222,11953,12322,10597,8203,6102,7643,67042,8630,10692,10737,8857,6847,6795,8672,61230
愛知県,2310,西三河南部東,はい,4364,4760,4210,2949,1717,831,755,19586,1132,1368,1215,922,581,363,443,6024
愛知県,2310,西三河南部東,いいえ,6079,7045,7023,6123,5354,4570,5825,42019,5763,6799,6559,5583,5175,5216,6711,41806
愛知県,2311,東三河北部,はい,333,375,346,258,206,112,147,1777,91,119,98,81,69,58,88,604
愛知県,2311,東三河北部,いいえ,573,664,632,639,683,782,1003,4976,461,606,591,624,769,893,1199,5143
愛知県,2312,東三河南部,はい,5424,6173,5561,4036,2465,1336,1233,26228,1504,1893,1750,1205,874,629,805,8660
愛知県,2312,東三河南部,いいえ,7513,9306,9433,8027,7163,5871,7084,54397,6643,8289,8546,7424,6960,6793,9238,53893
愛知県,2313,名古屋・尾張中部,はい,20693,23627,21784,15143,8819,4706,3836,98608,7110,8266,8212,5842,3642,2089,2493,37654
愛知県,2313,名古屋・尾張中部,いいえ,30148,35093,35262,30349,24393,18416,21412,195073,28044,33380,33225,27291,21889,19454,25695,188978
三重県,2401,北勢,はい,6810,8608,7778,5786,3451,1788,1798,36019,2243,2771,2636,1963,1232,833,1170,12848
三重県,2401,北勢,いいえ,10222,13279,13651,11799,9908,8605,11392,78856,9504,12578,12841,10835,9486,10130,14657,80031
三重県,2402,中勢伊賀,はい,3191,3798,3453,2695,1876,1228,1069,17310,1213,1546,1442,1111,838,565,642,7357
三重県,2402,中勢伊賀,いいえ,5011,6089,6027,5187,5285,4953,6000,38552,4756,5872,5938,5354,5491,5817,7703,40931
三重県,2403,南勢志摩,はい,2666,3310,3009,2527,1750,1081,1044,15387,981,1271,1264,1068,760,583,713,6640
三重県,2403,南勢志摩,いいえ,4675,6042,6115,5579,5308,5319,6864,39902,4515,6081,6176,5771,5802,6747,9071,44163
三重県,2404,東紀州,はい,230,306,321,262,219,166,171,1675,83,135,115,102,107,79,128,749
三重県,2404,東紀州,いいえ,592,842,819,805,783,944,1197,5982,525,672,773,818,913,1097,1686,6484
滋賀県,2501,大津,はい,2851,3516,3155,2318,1510,855,697,14902,1402,1642,1498,1111,741,392,377,7163
滋賀県,2501,大津,いいえ,4029,4811,4706,4278,3906,3334,4001,29065,4573,5438,5513,4673,4185,3628,4839,32849
滋賀県,2502,湖南,はい,3484,4023,3288,2325,1330,727,686,15863,1330,1505,1301,902,567,344,496,6445
滋賀県,2502,湖南,いいえ,4453,5135,4825,3974,3121,2769,3528,27805,4956,5817,5163,3805,3212,3317,4805,31075
滋賀県,2503,甲賀,はい,1335,1549,1420,977,767,436,446,6930,442,525,459,368,307,220,239,2560
滋賀県,2503,甲賀,いいえ,1752,2006,1875,1754,1721,1703,2100,12911,1671,2002,1884,1817,1948,1949,2598,13869
滋賀県,2504,東近江,はい,2150,2283,1970,1525,1046,628,585,10187,699,771,705,569,401,312,366,3823
滋賀県,2504,東近江,いいえ,2604,2925,2663,2388,2479,2261,2658,17978,2763,3137,2945,2812,2763,2689,3194,20303
滋賀県,2505,湖東,はい,1328,1490,1286,873,635,390,319,6321,456,524,531,364,307,192,199,2573
滋賀県,2505,湖東,いいえ,1815,2081,1868,1640,1593,1367,1454,11818,1779,2148,2008,1801,1714,1650,1865,12965
滋賀県,2506,湖北,はい,1133,1380,1212,948,695,399,305,6072,456,500,508,413,298,226,228,2629
滋賀県,2506,湖北,いいえ,1827,2088,2016,1848,1741,1542,1683,12745,1842,2179,2234,2097,1960,1831,1939,14082
滋賀県,2507,湖西,はい,265,314,338,301,251,129,110,1708,132,167,174,153,89,67,64,846
滋賀県,2507,湖西,いいえ,416,511,560,534,606,453,461,3541,462,558,623,673,663,519,615,4113
京都府,2601,丹後,はい,545,685,701,613,446,306,317,3613,274,355,336,300,227,156,196,1844
京都府,2601,丹後,いいえ,900,1274,1256,1210,1248,1166,1381,8435,865,1289,1385,1327,1337,1365,1609,9177
京都府,2602,中丹,はい,1149,1502,1289,971,756,504,482,6653,476,642,566,437,349,231,282,2983
京都府,2602,中丹,いいえ,1936,2417,2321,2122,2060,1910,2483,15249,1741,2405,2394,2077,2183,2076,3202,16078
京都府,2603,南丹,はい,936,1103,974,786,583,427,389,5198,335,480,431,388,290,206,270,2400
京都府,2603,南丹,いいえ,1271,1499,1444,1329,1455,1437,1836,10271,1300,1622,1681,1572,1698,1639,2155,11667
京都府,2604,京都・乙訓,はい,10850,13110,12410,8985,5787,3227,2852,57221,4926,5991,5609,4201,2464,1372,1576,26139
京都府,2604,京都・乙訓,いいえ,14945,18548,18420,15713,13774,10513,12780,104693,16569,19996,19838,16628,13460,11652,15608,113751
京都府,2605,山城北,はい,3288,4324,3835,2659,1663,1027,1194,17990,1291,1644,1463,1159,717,510,849,7633
京都府,2605,山城北,いいえ,4178,5724,5402,4493,3943,3829,5510,33079,4425,5991,5730,4740,4321,4955,8118,38280
京都府,2606,山城南,はい,958,1173,1007,706,454,303,299,4900,382,414,408,294,169,110,188,1965
京都府,2606,山城南,いいえ,1321,1635,1585,1293,1230,1132,1552,9748,1330,1730,1543,1364,1244,1372,1953,10536
大阪府,2701,豊能,はい,7772,9065,8495,5702,3435,1735,1417,37621,2870,3472,3373,2369,1348,691,707,14830
大阪府,2701,豊能,いいえ,10463,12695,13052,11029,8719,6578,8331,70867,11010,13598,13897,10732,8026,7409,10498,75170
大阪府,2702,三島,はい,5396,6828,6461,4198,2596,1333,1208,28020,2149,2627,2427,1653,1037,597,702,11192
大阪府,2702,三島,いいえ,7094,9099,8990,7053,5984,4863,6316,49399,7563,9692,9606,7062,5899,5704,8200,53726
大阪府,2703,北河内,はい,6720,8710,8157,5853,3514,1652,1064,35670,2586,3356,3368,2253,1209,567,438,13777
大阪府,2703,北河内,いいえ,8666,11647,12065,9783,7600,4628,3651,58040,8474,11480,11787,9015,6019,3730,3664,54169
大阪府,2704,中河内,はい,4733,5973,5945,4237,2560,1255,1038,25741,1762,2354,2530,1839,1031,604,629,10749
大阪府,2704,中河内,いいえ,6349,8632,9008,7294,5733,3949,4295,45260,6126,8657,9047,7508,5710,4515,5610,47173
大阪府,2705,南河内,はい,2902,3801,3870,3029,2067,1087,858,17614,1208,1501,1617,1205,729,423,439,7122
大阪府,2705,南河内,いいえ,3756,5184,5608,5056,4625,3932,4557,32718,3931,5522,5958,5160,4353,4125,5457,34506
大阪府,2706,堺市,はい,5237,7027,6680,4575,2778,1601,1453,29351,2194,2898,2821,1934,1227,771,923,12768
大阪府,2706,堺市,いいえ,6730,9320,9252,7251,5995,4974,6879,50401,7367,9731,9518,7514,5944,6313,9910,56297
大阪府,2707,泉州,はい,5033,6821,6512,4663,2947,1529,1134,28639,1961,2582,2650,1757,1052,622,632,11256
大阪府,2707,泉州,いいえ,6444,8751,9369,7786,6439,5226,5891,49906,6564,9115,9397,7619,5981,5555,6856,51087
大阪府,2708,大阪市,はい,20781,23662,22268,15504,9339,4252,2483,98289,10200,11697,11304,8457,4540,1649,1113,48960
大阪府,2708,大阪市,いいえ,27320,32745,33427,26996,20125,12148,9422,162183,30337,35253,34731,27919,19169,10779,9260,167448
兵庫県,2801,神戸,はい,11173,13782,12755,9276,6070,3354,2835,59245,4693,5799,5629,4245,2599,1413,1682,26060
兵庫県,2801,神戸,いいえ,14864,18603,19258,16628,15242,12934,15634,113163,15970,19941,19818,16867,15113,14354,19149,121212
兵庫県,2804,東播磨,はい,5280,6191,5785,3997,2502,1395,1088,26238,1891,2333,2190,1496,889,536,657,9992
兵庫県,2804,東播磨,いいえ,7819,9377,9138,7571,6745,5724,6817,53191,6871,8624,8675,6955,5945,6130,8140,51340
兵庫県,2805,北播磨,はい,1609,1988,1769,1417,963,610,505,8861,586,730,672,553,349,241,253,3384
兵庫県,2805,北播磨,いいえ,2396,2985,2996,2729,2571,2418,2870,18965,2300,2989,3013,2723,2681,2719,3275,19700
兵庫県,2808,但馬,はい,970,1201,1042,858,695,499,434,5699,369,464,517,423,311,262,249,2595
兵庫県,2808,但馬,いいえ,1748,2140,2051,1954,2246,2196,2586,14921,1682,2241,2295,2277,2466,2561,2922,16444
兵庫県,2809,丹波,はい,588,718,629,493,419,278,238,3363,224,282,278,218,147,129,126,1404
兵庫県,2809,丹波,いいえ,1024,1157,1046,994,1166,1099,1240,7726,940,1128,1141,1172,1327,1250,1391,8349
兵庫県,2810,淡路,はい,605,788,715,628,520,400,401,4057,302,361,361,255,230,201,222,1932
兵庫県,2810,淡路,いいえ,1151,1376,1324,1251,1360,1459,1697,9618,1257,1535,1452,1429,1685,1807,2160,11325
兵庫県,2811,阪神,はい,11538,14885,14158,10358,6085,3011,2505,62540,4736,5977,5905,4276,2521,1269,1414,26098
兵庫県,2811,阪神,いいえ,15120,19712,21035,17839,14749,11380,13124,112959,16376,21557,22344,17543,13775,11844,15513,118952
兵庫県,2812,播磨姫路,はい,5441,6752,5914,4535,3082,1785,1643,29152,1880,2544,2293,1765,1183,786,992,11443
兵庫県,2812,播磨姫路,いいえ,8241,10264,9766,8730,7981,7412,9441,61835,7481,9930,9567,8469,7860,8799,12416,64522
奈良県,2901,奈良,はい,2054,2622,2625,1936,1217,672,443,11569,947,1161,1197,878,494,267,249,5193
奈良県,2901,奈良,いいえ,2773,3636,3861,3565,3265,2449,2608,22157,3336,4344,4611,3822,3023,2664,3086,24886
奈良県,2902,東和,はい,972,1235,1216,970,603,439,385,5820,451,549,583,415,283,204,279,2764
奈良県,2902,東和,いいえ,1544,2048,2054,1887,1901,1748,2223,13405,1660,2037,2123,2038,1988,2054,2733,14633
奈良県,2903,西和,はい,2165,2810,2594,1795,1188,648,638,11838,923,1142,1001,796,456,324,417,5059
奈良県,2903,西和,いいえ,2866,3784,3924,3454,3041,2843,4080,23992,3263,4243,4297,3533,3252,3692,5759,28039
奈良県,2904,中和,はい,2259,2814,2624,1968,1267,739,655,12326,939,1169,1149,862,543,364,440,5466
奈良県,2904,中和,いいえ,3175,4086,4293,3728,3322,3004,3796,25404,3418,4297,4589,3979,3501,3657,5046,28487
奈良県,2905,南和,はい,222,311,313,271,239,146,136,1638,128,143,147,189,103,66,75,851
奈良県,2905,南和,いいえ,390,505,607,635,731,656,629,4153,417,587,581,684,782,684,754,4489
和歌山県,3001,和歌山,はい,2484,3153,2861,2254,1456,943,922,14073,907,1202,1178,943,594,445,690,5959
和歌山県,3001,和歌山,いいえ,3872,4917,4863,4240,4109,3583,4710,30294,3332,4324,4462,4070,3745,4234,6299,30466
和歌山県,3002,那賀,はい,642,825,782,618,443,284,288,3882,265,345,343,279,181,155,191,1759
和歌山県,3002,那賀,いいえ,881,1178,1178,1073,1122,1090,1312,7834,872,1162,1272,1252,1208,1301,1665,8732
和歌山県,3003,橋本,はい,377,512,450,429,370,237,222,2597,186,212,213,178,132,112,142,1175
和歌山県,3003,橋本,いいえ,609,808,781,757,844,943,1103,5845,606,861,910,888,1019,1087,1378,6749
和歌山県,3004,有田,はい,369,424,369,309,230,156,164,2021,155,171,182,147,101,97,126,979
和歌山県,3004,有田,いいえ,593,795,770,721,707,729,890,5205,673,774,869,788,818,892,988,5802
和歌山県,3005,御坊,はい,325,398,327,286,218,130,187,1871,133,163,142,96,109,73,89,805
和歌山県,3005,御坊,いいえ,643,816,756,712,744,779,778,5228,581,718,747,754,732,888,927,5347
和歌山県,3006,田辺,はい,530,707,636,549,401,266,252,3341,275,333,329,308,195,138,172,1750
和歌山県,3006,田辺,いいえ,1172,1511,1442,1379,1432,1259,1386,9581,1183,1436,1434,1500,1462,1448,1739,10202
和歌山県,3007,新宮,はい,205,289,281,251,181,115,115,1437,96,138,140,141,95,76,99,785
和歌山県,3007,新宮,いいえ,469,648,662,609,666,632,922,4608,407,518,584,608,680,840,1191,4828
鳥取県,3101,東部,はい,1441,1672,1405,1148,906,638,577,7787,734,797,754,627,448,396,421,4177
鳥取県,3101,東部,いいえ,2663,3101,2634,2542,2603,2508,2651,18702,2514,3009,2770,2613,2762,2916,3255,19839
鳥取県,3102,中部,はい,544,590,492,462,375,261,240,2964,260,349,253,238,195,170,192,1657
鳥取県,3102,中部,いいえ,973,1056,1032,973,1039,1025,1066,7164,908,1132,1026,1004,1128,1187,1306,7691
鳥取県,3103,西部,はい,1432,1704,1346,1141,885,585,531,7624,719,793,716,583,443,314,348,3916
鳥取県,3103,西部,いいえ,2357,2724,2672,2436,2428,2160,2308,17085,2280,2801,2596,2417,2356,2312,3035,17797
島根県,3201,松江,はい,1524,1763,1721,1261,935,660,588,8452,728,881,780,586,379,311,434,4099
島根県,3201,松江,いいえ,2647,3229,2989,2652,2712,2476,2957,19662,2704,3451,3221,2952,2936,2894,3796,21954
島根県,3202,雲南,はい,282,368,302,261,262,242,273,1990,155,183,155,132,120,104,150,999
島根県,3202,雲南,いいえ,636,770,625,628,793,786,897,5135,623,720,676,714,795,800,1005,5333
島根県,3203,出雲,はい,1187,1349,1110,883,717,526,524,6296,574,598,526,421,301,241,320,2981
島根県,3203,出雲,いいえ,1891,2224,2030,1886,1944,1901,2339,14215,1981,2393,2063,2047,2104,2360,2807,15755
島根県,3204,大田,はい,271,314,244,235,213,185,197,1659,129,160,124,116,102,87,126,844
島根県,3204,大田,いいえ,530,627,563,529,650,686,861,4446,487,636,595,600,776,852,1044,4990
島根県,3205,浜田,はい,413,513,449,362,354,279,306,2676,215,247,220,200,154,131,204,1371
島根県,3205,浜田,いいえ,820,1002,851,858,999,1027,1320,6877,755,956,899,865,1041,1180,1617,7313
島根県,3206,益田,はい,326,381,278,294,260,234,244,2017,164,181,155,135,142,128,146,1051
島根県,3206,益田,いいえ,647,754,619,654,777,882,1112,5445,525,691,617,645,772,1014,1411,5675
島根県,3207,隠岐,はい,112,110,87,76,52,44,70,551,51,65,42,32,25,28,40,283
島根県,3207,隠岐,いいえ,241,250,183,212,238,293,343,1760,219,252,214,225,242,316,428,1896
岡山県,3301,県南東部,はい,6866,8375,6997,5164,3586,2259,1832,35079,2937,3531,3233,2332,1556,973,1129,15691
岡山県,3301,県南東部,いいえ,9336,11806,10946,9323,8756,7898,8959,67024,9790,12276,11670,9970,9379,9102,11532,73719
岡山県,3302,県南西部,はい,4949,6212,5323,3777,2541,1580,1349,25731,1972,2463,2177,1537,1041,659,879,10728
岡山県,3302,県南西部,いいえ,7368,9196,8534,6899,6549,5959,6373,50878,7011,9373,8782,6961,6585,6569,8015,53296
岡山県,3303,高梁・新見,はい,245,335,295,259,245,216,191,1786,113,134,109,119,115,85,95,770
岡山県,3303,高梁・新見,いいえ,494,585,554,565,740,678,683,4299,454,587,542,584,751,766,816,4500
岡山県,3304,真庭,はい,245,282,223,188,211,147,159,1455,105,109,98,111,92,82,70,667
岡山県,3304,真庭,いいえ,463,521,425,438,553,563,646,3609,449,507,478,537,617,693,812,4093
岡山県,3305,津山・英田,はい,972,1151,935,717,594,430,405,5204,440,530,448,371,305,222,232,2548
岡山県,3305,津山・英田,いいえ,1657,2028,1848,1457,1749,1753,1986,12478,1691,2047,1912,1719,2002,2012,2424,13807
広島県,3401,広島,はい,10550,13054,11857,8333,5237,2459,1504,52994,4404,5414,5133,3600,2003,907,713,22174
広島県,3401,広島,いいえ,15104,19092,18801,15813,12805,7746,5885,95246,14299,18051,17161,13299,9875,6216,5355,84256
広島県,3402,広島西,はい,924,1061,973,729,571,315,214,4787,381,470,473,350,224,134,106,2138
広島県,3402,広島西,いいえ,1304,1676,1561,1503,1486,1263,1249,10042,1242,1576,1529,1378,1367,1205,1126,9423
広島県,3403,呉,はい,1050,1530,1458,1236,847,520,420,7061,486,729,695,573,374,236,274,3367
広島県,3403,呉,いいえ,1875,2791,2631,2347,2162,1829,2012,15647,1763,2455,2372,2165,1908,1788,2474,14925
広島県,3404,広島中央,はい,1774,2204,1921,1408,904,477,401,9089,631,833,758,488,364,204,206,3484
広島県,3404,広島中央,いいえ,2570,3111,3023,2609,2295,1601,1682,16891,1974,2658,2510,2160,1985,1595,1865,14747
広島県,3405,尾三,はい,1372,1711,1385,1145,891,599,519,7622,534,689,682,549,424,271,310,3459
広島県,3405,尾三,いいえ,2175,2788,2626,2258,2354,2161,2386,16748,1940,2627,2495,2284,2455,2438,2845,17084
広島県,3406,福山・府中,はい,3498,4060,3395,2514,1759,1079,812,17117,1331,1632,1542,1067,768,442,447,7229
広島県,3406,福山・府中,いいえ,5194,6514,5835,4876,4502,3733,3893,34547,4662,5842,5486,4559,4126,3866,4349,32890
広島県,3407,備北,はい,444,543,501,368,368,303,326,2853,254,316,284,231,178,158,193,1614
広島県,3407,備北,いいえ,811,965,843,818,924,981,1082,6424,776,948,888,900,1075,1165,1253,7005
山口県,3501,岩国,はい,601,767,740,610,469,299,276,3762,259,344,373,287,187,119,183,1752
山口県,3501,岩国,いいえ,1081,1515,1477,1322,1316,1267,1521,9499,981,1367,1447,1228,1231,1430,1844,9528
山口県,3502,柳井,はい,347,440,413,346,289,210,186,2231,153,221,188,172,129,87,119,1069
山口県,3502,柳井,いいえ,657,921,813,654,731,722,730,5228,594,791,872,680,764,821,973,5495
山口県,3503,周南,はい,1555,2083,1791,1247,860,528,523,8587,598,777,736,534,382,256,384,3667
山口県,3503,周南,いいえ,2510,3368,3262,2558,2398,2206,2764,19066,2290,3268,3094,2520,2396,2603,3775,19946
山口県,3504,山口・防府,はい,2309,2806,2431,1850,1361,723,600,12080,875,1059,1028,714,444,297,329,4746
山口県,3504,山口・防府,いいえ,3352,4224,3840,3377,3314,2679,2777,23563,2849,3557,3379,2946,2885,2615,3017,21248
山口県,3505,宇部・小野田,はい,1464,1708,1493,1181,817,580,470,7713,581,700,729,554,341,247,255,3407
山口県,3505,宇部・小野田,いいえ,2489,3188,2835,2530,2430,2076,2343,17891,2124,2525,2603,2256,2218,2329,2997,17052
山口県,3506,下関,はい,1444,1781,1501,1183,904,506,266,7585,588,771,737,614,375,180,124,3389
山口県,3506,下関,いいえ,2202,2860,2530,2248,2065,1524,994,14423,1913,2424,2507,2229,1888,1178,923,13062
山口県,3507,長門,はい,194,212,202,147,134,127,119,1135,70,120,107,98,80,51,62,588
山口県,3507,長門,いいえ,327,402,325,277,368,310,368,2377,304,327,359,330,421,437,505,2683
山口県,3508,萩,はい,205,283,275,238,225,167,167,1560,104,133,124,100,92,74,104,731
山口県,3508,萩,いいえ,424,547,487,456,520,588,625,3647,336,492,535,520,585,721,850,4039
徳島県,3601,東部,はい,2886,3542,3041,2610,1876,1314,1457,16726,1441,1720,1692,1325,924,838,1072,9012
徳島県,3601,東部,いいえ,4868,5733,5551,4983,4832,4688,5736,36391,4860,6054,5857,5351,5261,6210,7587,41180
徳島県,3603,南部,はい,798,993,812,685,552,448,584,4872,327,424,469,376,286,255,373,2510
徳島県,3603,南部,いいえ,1309,1537,1449,1338,1352,1570,2088,10643,1201,1451,1530,1430,1644,2075,2788,12119
徳島県,3605,西部,はい,253,299,285,290,276,243,269,1915,145,158,155,165,127,119,175,1044
徳島県,3605,西部,いいえ,629,669,661,686,829,1007,1163,5644,574,721,714,805,973,1180,1386,6353
香川県,3702,小豆,はい,102,112,114,108,89,58,86,669,74,69,71,74,42,35,41,406
香川県,3702,小豆,いいえ,222,229,212,218,225,286,424,1816,224,273,260,248,304,403,598,2310
香川県,3706,東部,はい,3505,4369,3803,2706,2013,1127,1054,18577,1572,2022,1845,1295,878,559,692,8863
香川県,3706,東部,いいえ,5452,7064,6574,5663,5143,4769,6060,40725,5667,7289,6818,5631,5469,5680,8116,44670
香川県,3707,西部,はい,2329,2999,2453,1980,1493,984,975,13213,1083,1342,1207,926,730,459,588,6335
香川県,3707,西部,いいえ,3486,4164,3936,3416,3724,3801,4817,27344,3513,4506,4209,3803,4067,4598,6369,31065
愛媛県,3801,宇摩,はい,527,665,572,497,313,166,104,2844,234,275,240,211,108,65,59,1192
愛媛県,3801,宇摩,いいえ,852,1064,935,888,778,607,592,5716,735,936,923,788,692,675,641,5390
愛媛県,3802,新居浜・西条,はい,1332,1658,1362,1143,750,374,272,6891,496,626,607,519,283,169,126,2826
愛媛県,3802,新居浜・西条,いいえ,2185,2762,2459,2217,2020,1483,1509,14635,2029,2490,2303,2073,1799,1547,1771,14012
愛媛県,3803,今治,はい,850,1092,972,716,571,378,350,4929,392,472,515,351,256,168,193,2347
愛媛県,3803,今治,いいえ,1668,2089,1948,1665,1551,1307,1588,11816,1422,1891,1873,1641,1550,1392,1892,11661
愛媛県,3804,松山,はい,4625,5693,4954,3688,2529,1297,819,23605,2071,2529,2371,1706,1089,551,425,10742
愛媛県,3804,松山,いいえ,7335,8905,8154,7150,6773,4927,3909,47153,7197,8602,8174,7038,6283,4909,4477,46680
愛媛県,3805,八幡浜・大洲,はい,665,807,770,689,551,377,329,4188,351,417,418,355,242,179,165,2127
愛媛県,3805,八幡浜・大洲,いいえ,1292,1661,1436,1581,1659,1336,1366,10331,1271,1520,1671,1606,1642,1554,1670,10934
愛媛県,3806,宇和島,はい,527,651,580,536,409,294,284,3281,291,393,353,317,235,142,164,1895
愛媛県,3806,宇和島,いいえ,1008,1294,1151,1161,1166,1008,1223,8011,976,1320,1355,1316,1385,1407,1629,9388
高知県,3901,安芸,はい,203,222,230,219,184,159,184,1401,103,143,130,120,85,109,113,803
高知県,3901,安芸,いいえ,401,493,486,467,485,487,639,3458,327,439,458,479,561,706,993,3963
高知県,3902,中央,はい,3279,4086,3558,2831,2115,1537,1534,18940,1879,2272,2121,1585,1090,674,917,10538
高知県,3902,中央,いいえ,5500,6858,5952,5274,5052,4653,5464,38753,5414,6766,6418,5757,5697,5727,7287,43066
高知県,3903,高幡,はい,260,260,290,216,251,198,238,1713,133,152,146,126,106,118,124,905
高知県,3903,高幡,いいえ,507,609,561,547,625,730,905,4484,396,560,526,568,686,847,1064,4647
高知県,3904,幡多,はい,337,411,341,289,267,268,297,2210,228,265,230,178,148,113,201,1363
高知県,3904,幡多,いいえ,708,891,779,702,841,929,1188,6038,661,917,854,856,1001,1345,1705,7339
福岡県,4001,福岡・糸島,はい,14232,15319,12946,8960,5772,3442,2843,63514,6597,6925,5914,4116,2589,1562,1689,29392
福岡県,4001,福岡・糸島,いいえ,17328,19471,18738,15916,13848,11168,12075,108544,19512,21678,19917,15960,13205,12051,14616,116939
福岡県,4002,粕屋,はい,2836,3232,2390,1579,1106,713,489,12345,1090,1227,933,682,420,267,249,4868
福岡県,4002,粕屋,いいえ,3137,3715,3066,2404,2492,2152,2236,19202,3450,3815,3146,2501,2413,2225,2394,19944
福岡県,4003,宗像,はい,1313,1326,972,782,608,370,271,5642,512,508,462,348,252,148,117,2347
福岡県,4003,宗像,いいえ,1617,1615,1483,1255,1474,1433,1555,10432,1769,1866,1658,1540,1535,1594,1719,11681
福岡県,4004,筑紫,はい,3373,3863,3261,2273,1529,926,780,16005,1448,1544,1483,979,606,352,421,6833
福岡県,4004,筑紫,いいえ,4024,4760,4445,3907,3848,3470,3959,28413,4517,5497,5096,4383,3915,3859,4759,32026
福岡県,4005,朝倉,はい,657,646,569,452,350,293,264,3231,276,300,284,246,164,148,156,1574
福岡県,4005,朝倉,いいえ,781,883,761,702,828,920,1055,5930,758,921,856,871,954,1125,1303,6788
福岡県,4006,久留米,はい,3108,3495,2845,2213,1563,1025,875,15124,1378,1534,1490,1044,707,471,544,7168
福岡県,4006,久留米,いいえ,3752,4267,4057,3852,4054,3819,4287,28088,4094,4918,4891,4513,4308,4564,5436,32724
福岡県,4007,八女・筑後,はい,872,913,796,641,510,341,329,4402,375,422,408,333,176,158,196,2068
福岡県,4007,八女・筑後,いいえ,1207,1335,1234,1249,1425,1402,1608,9460,1234,1448,1497,1515,1621,1732,1998,11045
福岡県,4008,有明,はい,1031,1139,1049,946,726,495,466,5852,487,533,531,462,303,219,303,2838
福岡県,4008,有明,いいえ,1601,1797,1764,1793,2005,1998,2483,13441,1570,1974,1963,2091,2150,2585,3373,15706
福岡県,4009,飯塚,はい,1054,1200,917,716,627,488,470,5472,571,657,523,424,373,272,335,3155
福岡県,4009,飯塚,いいえ,1587,1739,1485,1347,1643,1690,2275,11766,1665,1969,1793,1563,1902,2218,2975,14085
福岡県,4010,直方・鞍手,はい,736,714,615,432,393,292,275,3457,286,337,310,223,166,121,147,1590
福岡県,4010,直方・鞍手,いいえ,1012,1111,888,847,1015,1024,1328,7225,915,954,1003,924,1049,1265,1668,7778
福岡県,4011,田川,はい,589,648,538,437,370,307,261,3150,307,369,276,217,206,178,168,1721
福岡県,4011,田川,いいえ,946,1140,1001,864,1018,1100,1311,7380,985,1185,1146,1123,1153,1362,1645,8599
福岡県,4012,北九州,はい,7641,8658,7369,5617,4154,2749,2437,38625,3131,3721,3614,2795,1758,1154,1386,17559
福岡県,4012,北九州,いいえ,9793,11772,11355,9988,10132,9646,11785,74471,9936,12106,12173,10602,10015,10808,15514,81154
福岡県,4013,京築,はい,1229,1462,1283,980,714,477,451,6596,460,604,534,378,294,236,274,2780
福岡県,4013,京築,いいえ,1819,2242,2033,1823,1931,2017,2401,14266,1715,2144,2060,1852,1949,2332,2968,15020
佐賀県,4101,中部,はい,2339,2489,2174,1763,1314,921,758,11758,1043,1220,1044,844,616,413,347,5527
佐賀県,4101,中部,いいえ,3325,3839,3681,3626,3625,3651,4001,25748,3481,4103,4055,3898,3895,4175,4703,28310
佐賀県,4102,東部,はい,1114,1161,972,686,429,313,291,4966,399,450,393,260,208,138,134,1982
佐賀県,4102,東部,いいえ,1342,1492,1278,1198,1242,1247,1555,9354,1212,1460,1409,1106,1226,1476,2013,9902
佐賀県,4103,北部,はい,691,771,608,499,463,396,383,3811,349,391,358,321,278,238,259,2194
佐賀県,4103,北部,いいえ,1012,1167,1010,1073,1168,1173,1352,7955,1126,1302,1140,1265,1392,1457,1568,9250
佐賀県,4104,西部,はい,503,480,417,332,296,229,201,2458,211,225,186,164,121,112,110,1129
佐賀県,4104,西部,いいえ,804,832,791,835,867,920,1005,6054,778,826,826,887,956,1110,1383,6766
佐賀県,4105,南部,はい,777,804,742,680,509,399,395,4306,339,389,333,299,220,203,211,1994
佐賀県,4105,南部,いいえ,1200,1306,1263,1496,1614,1735,2151,10765,1136,1330,1406,1496,1838,2217,2776,12199
長崎県,4201,長崎,はい,2818,3392,3183,2452,1949,1292,1342,16428,1376,1580,1536,1124,788,591,816,7811
長崎県,4201,長崎,いいえ,4397,5526,5634,5436,5320,5331,6374,38018,4915,6018,5989,5776,5723,6405,8172,42998
長崎県,4202,佐世保県北,はい,1341,1540,1307,1102,929,737,734,7690,667,757,706,535,408,375,403,3851
長崎県,4202,佐世保県北,いいえ,2138,2566,2439,2553,2646,2859,3454,18655,2336,2726,2763,2663,2839,3579,4536,21442
長崎県,4203,県央,はい,1661,1791,1614,1308,994,663,622,8653,779,811,713,570,370,306,362,3911
長崎県,4203,県央,いいえ,2577,3099,2897,2798,2811,2849,3097,20128,2604,2990,3122,2944,2988,3384,4210,22242
長崎県,4204,県南,はい,517,573,523,551,456,379,416,3415,257,271,292,235,218,214,234,1721
長崎県,4204,県南,いいえ,990,1166,1229,1273,1520,1582,1914,9674,1068,1321,1462,1579,1829,2184,2623,12066
長崎県,4206,五島,はい,115,104,105,114,109,131,103,781,69,62,64,50,51,56,63,415
長崎県,4206,五島,いいえ,285,357,359,352,392,447,505,2697,260,298,342,379,493,584,657,3013
長崎県,4207,上五島,はい,71,80,83,91,88,77,55,545,26,50,43,50,27,31,30,257
長崎県,4207,上五島,いいえ,229,268,248,285,294,311,303,1938,160,199,201,264,315,340,395,1874
長崎県,4208,壱岐,はい,131,139,154,120,117,122,143,926,89,71,66,66,54,66,84,496
長崎県,4208,壱岐,いいえ,224,267,255,254,281,301,386,1968,246,300,250,311,326,395,526,2354
長崎県,4209,対馬,はい,110,124,94,78,92,85,96,679,58,53,56,49,59,42,63,380
長崎県,4209,対馬,いいえ,279,335,325,318,392,448,501,2598,274,326,315,342,420,559,613,2849
熊本県,4302,宇城,はい,657,706,645,577,441,298,294,3618,335,357,321,233,189,142,144,1721
熊本県,4302,宇城,いいえ,903,1013,961,1108,1121,1106,1129,7341,927,1060,1110,1119,1189,1237,1310,7952
熊本県,4303,有明,はい,949,903,796,665,526,395,341,4575,382,448,368,308,224,169,183,2082
熊本県,4303,有明,いいえ,1426,1478,1345,1416,1504,1574,1715,10458,1384,1618,1541,1566,1703,1715,1978,11505
熊本県,4304,鹿本,はい,332,324,293,245,203,144,140,1681,137,137,142,116,80,67,69,748
熊本県,4304,鹿本,いいえ,447,468,481,494,538,527,558,3513,452,521,555,548,609,604,645,3934
熊本県,4305,菊池,はい,1743,1726,1248,966,673,466,376,7198,744,754,559,446,305,198,217,3223
熊本県,4305,菊池,いいえ,2235,2464,2027,2006,1984,1818,1726,14260,2400,2425,2092,1992,1963,1866,1843,14581
熊本県,4306,阿蘇,はい,331,323,282,290,267,269,228,1990,192,188,199,147,140,123,144,1133
熊本県,4306,阿蘇,いいえ,576,629,587,679,769,981,1101,5322,598,696,690,798,914,1182,1276,6154
熊本県,4308,八代,はい,895,941,795,733,516,361,300,4541,434,481,421,309,233,176,198,2252
熊本県,4308,八代,いいえ,1248,1429,1420,1411,1462,1375,1430,9775,1290,1574,1527,1655,1752,1773,1803,11374
熊本県,4309,芦北,はい,196,202,208,202,156,115,87,1166,103,95,116,81,62,55,49,561
熊本県,4309,芦北,いいえ,374,439,504,528,516,500,461,3322,335,390,426,505,536,556,515,3263
熊本県,4310,球磨,はい,455,487,455,451,386,339,330,2903,288,326,269,226,189,185,173,1656
熊本県,4310,球磨,いいえ,878,1019,965,1090,1303,1350,1553,8158,930,1060,1109,1235,1386,1566,1931,9217
熊本県,4311,天草,はい,525,572,551,533,490,403,388,3462,304,360,323,305,235,191,188,1906
熊本県,4311,天草,いいえ,1054,1204,1224,1249,1543,1593,1673,9540,1147,1388,1486,1710,1884,2098,2097,11810
熊本県,4312,熊本・上益城,はい,5726,6514,5365,4320,2994,1992,1558,28469,2840,3156,2660,1992,1248,852,918,13666
熊本県,4312,熊本・上益城,いいえ,8089,9279,8561,8507,8418,7506,7535,57895,9085,10664,9985,9453,8723,8398,9568,65876
大分県,4401,東部,はい,1019,1209,1088,975,801,607,623,6322,573,661,668,540,399,335,388,3564
大分県,4401,東部,いいえ,1550,1858,1778,1652,1986,2155,2706,13685,1803,2209,2295,2295,2467,2699,3708,17476
大分県,4403,中部,はい,4194,4895,3944,3171,2299,1660,1248,21411,1875,2222,1899,1380,991,677,779,9823
大分県,4403,中部,いいえ,6130,7390,6629,5790,6340,5813,6403,44495,6549,7771,7390,6551,6603,6609,8030,49503
大分県,4405,南部,はい,317,383,299,293,218,187,221,1918,169,160,173,109,123,97,113,944
大分県,4405,南部,いいえ,623,697,677,697,766,948,1103,5511,597,697,761,789,942,1185,1537,6508
大分県,4406,豊肥,はい,252,280,271,263,271,190,225,1752,136,167,159,116,142,124,141,985
大分県,4406,豊肥,いいえ,441,485,481,471,737,819,1054,4488,512,545,554,624,895,1019,1246,5395
大分県,4408,西部,はい,465,519,468,435,348,266,216,2717,221,243,232,195,187,126,114,1318
大分県,4408,西部,いいえ,842,1016,928,1009,1209,1171,1259,7434,838,988,1000,1075,1178,1244,1529,7852
大分県,4409,北部,はい,1236,1276,1004,896,695,460,416,5983,399,434,429,343,302,237,253,2397
大分県,4409,北部,いいえ,1666,1874,1814,1669,1709,1693,1924,12349,1452,1723,1750,1646,1833,2064,2533,13001
宮崎県,4501,宮崎東諸県,はい,3199,3769,3029,2401,1698,1222,904,16222,1570,1833,1594,1144,696,508,566,7911
宮崎県,4501,宮崎東諸県,いいえ,4510,5300,4968,4516,4481,3795,4026,31596,4463,5523,5063,4562,4277,4180,4980,33048
宮崎県,4502,都城北諸県,はい,1248,1291,998,897,827,625,697,6583,593,552,478,437,379,372,506,3317
宮崎県,4502,都城北諸県,いいえ,1798,1927,1716,1654,2047,2086,2661,13889,1666,1982,1925,1902,2317,2861,3658,16311
宮崎県,4503,延岡西臼杵,はい,1139,1300,1176,906,652,479,411,6063,450,534,491,362,252,216,234,2539
宮崎県,4503,延岡西臼杵,いいえ,1547,1846,1773,1757,1791,1719,2265,12698,1352,1679,1637,1643,1813,2108,2755,12987
宮崎県,4504,日南串間,はい,332,314,320,264,245,197,200,1872,132,172,131,120,105,98,132,890
宮崎県,4504,日南串間,いいえ,471,548,520,569,710,754,859,4431,451,474,517,641,720,896,1172,4871
宮崎県,4505,西諸,はい,360,344,303,336,301,292,342,2278,205,188,171,175,159,187,268,1353
宮崎県,4505,西諸,いいえ,542,541,502,573,771,866,1128,4923,508,546,532,706,854,1082,1343,5571
宮崎県,4506,西都児湯,はい,476,588,500,463,374,360,341,3102,276,314,246,204,177,179,190,1586
宮崎県,4506,西都児湯,いいえ,791,838,738,769,942,1141,1328,6547,785,967,944,958,1106,1394,1770,7924
宮崎県,4507,日向入郷,はい,479,548,427,347,300,263,264,2628,244,273,231,158,147,115,166,1334
宮崎県,4507,日向入郷,いいえ,799,894,764,826,816,910,1082,6091,770,838,881,820,884,1035,1408,6636
鹿児島県,4601,鹿児島,はい,4918,5288,4532,3646,2985,2203,1974,25546,2339,2488,2185,1713,1180,994,1188,12087
鹿児島県,4601,鹿児島,いいえ,5774,6994,6312,6296,6700,6553,7725,46354,6108,7060,6824,6289,6741,7790,9844,50656
鹿児島県,4603,南薩,はい,524,563,543,537,616,632,669,4084,260,280,261,267,250,310,443,2071
鹿児島県,4603,南薩,いいえ,934,976,1015,1157,1374,1798,2206,9460,835,949,1032,1201,1648,2289,2853,10807
鹿児島県,4605,川薩,はい,766,789,701,744,642,559,648,4849,370,415,351,338,311,269,358,2412
鹿児島県,4605,川薩,いいえ,1038,1175,1095,1263,1392,1576,2009,9548,995,1092,1236,1299,1523,2012,2498,10655
鹿児島県,4606,出水,はい,482,498,457,427,370,323,315,2872,234,246,260,201,171,168,199,1479
鹿児島県,4606,出水,いいえ,669,713,750,785,818,948,1174,5857,686,789,806,882,987,1292,1464,6906
鹿児島県,4607,姶良・伊佐,はい,1616,1722,1549,1427,1185,868,924,9291,765,825,753,655,533,438,575,4544
鹿児島県,4607,姶良・伊佐,いいえ,2107,2414,2405,2493,2650,2660,3401,18130,2087,2423,2553,2581,2832,3293,4328,20097
鹿児島県,4609,曽於,はい,378,356,364,339,388,363,330,2518,191,177,158,185,208,186,229,1334
鹿児島県,4609,曽於,いいえ,570,585,604,694,835,827,1011,5126,495,534,609,705,880,1029,1185,5437
鹿児島県,4610,肝属,はい,892,797,703,703,694,608,611,5008,403,437,418,353,311,298,366,2586
鹿児島県,4610,肝属,いいえ,1249,1310,1265,1319,1575,1679,1918,10315,1110,1266,1329,1433,1785,2084,2461,11468
鹿児島県,4611,熊毛,はい,181,218,223,187,189,164,164,1326,104,101,95,80,79,87,103,649
鹿児島県,4611,熊毛,いいえ,347,398,400,424,425,460,486,2940,289,320,367,331,409,559,613,2888
鹿児島県,4612,奄美,はい,484,571,538,529,523,534,474,3653,328,335,321,298,278,336,361,2257
鹿児島県,4612,奄美,いいえ,825,897,856,941,989,1197,1252,6957,856,923,863,897,1178,1504,1602,7823
沖縄県,4701,北部,はい,563,663,496,456,465,484,411,3538,333,374,261,280,274,267,255,2044
沖縄県,4701,北部,いいえ,961,998,831,829,1008,1101,1138,6866,934,945,800,915,1083,1141,1166,6984
沖縄県,4702,中部,はい,2834,3283,2669,1963,1474,1043,785,14051,1785,2073,1707,1242,850,589,517,8763
沖縄県,4702,中部,いいえ,4122,5120,4667,4012,3306,2568,2293,26088,4423,5399,4929,4094,3488,2999,2836,28168
沖縄県,4703,南部,はい,4210,4916,4120,3117,2423,1848,1536,22170,2850,3080,2700,1983,1474,1272,1193,14552
沖縄県,4703,南部,いいえ,6573,7716,7208,6215,5349,4786,4819,42666,7137,8271,8033,6958,6097,6016,6145,48657
沖縄県,4704,宮古,はい,268,297,249,269,264,267,206,1820,182,197,155,174,180,165,132,1185
沖縄県,4704,宮古,いいえ,450,516,429,473,495,523,431,3317,469,463,415,476,584,601,558,3566
沖縄県,4705,八重山,はい,162,193,153,113,140,152,148,1061,123,120,91,74,99,103,113,723
沖縄県,4705,八重山,いいえ,254,288,289,226,246,275,294,1872,286,301,258,263,279,350,379,2116
二次医療圏判別不可,,,はい,27067,30423,29198,22578,9367,2000,805,121438,7414,8671,8163,5439,2394,589,258,32928
二次医療圏判別不可,,,いいえ,48612,51580,52427,51318,28086,8410,5406,245839,28665,33219,31828,24495,12191,4644,2514,137556
