都道府県名,二次医療圏番号,二次医療圏名,回答,男40～44歳,男45～49歳,男50～54歳,男55～59歳,男60～64歳,男65～69歳,男70～74歳,男中計,女40～44歳,女45～49歳,女50～54歳,女55～59歳,女60～64歳,女65～69歳,女70～74歳,女中計
北海道,0101,南渡島,はい,2519,3091,2742,2269,1803,1238,945,14607,909,1367,1280,1089,772,554,328,6299
北海道,0101,南渡島,いいえ,2758,3550,3353,3155,3094,2994,3465,22369,3269,4080,4168,3788,3613,3767,5039,27724
北海道,0102,南檜山,はい,139,151,156,142,113,95,56,852,60,66,67,70,56,38,26,383
北海道,0102,南檜山,いいえ,146,221,215,205,209,191,237,1424,165,192,202,191,211,241,342,1544
北海道,0103,北渡島檜山,はい,242,268,246,203,185,120,78,1342,82,88,93,92,57,35,21,468
北海道,0103,北渡島檜山,いいえ,232,270,259,261,240,252,299,1813,226,320,255,289,269,330,407,2096
北海道,0104,札幌,はい,16407,19531,17971,14467,10997,5814,2731,87918,5046,7010,6732,5259,3480,1554,625,29706
北海道,0104,札幌,いいえ,24483,29478,28431,25651,23311,14949,9515,155818,27937,32557,30801,25970,18775,10693,8132,154865
北海道,0105,後志,はい,1178,1538,1407,1193,962,694,574,7546,382,625,563,470,444,266,228,2978
北海道,0105,後志,いいえ,1583,2067,2005,1942,1760,1749,1866,12972,1603,2076,2039,1966,1801,1943,2622,14050
北海道,0106,南空知,はい,850,1161,959,961,841,613,395,5780,315,436,449,388,310,198,155,2251
北海道,0106,南空知,いいえ,1048,1495,1394,1445,1544,1486,1570,9982,1123,1554,1592,1571,1553,1547,2070,11010
北海道,0107,中空知,はい,574,796,718,663,585,371,339,4046,263,321,336,309,274,205,155,1863
北海道,0107,中空知,いいえ,642,983,923,939,923,917,1187,6514,827,1135,1042,1106,1048,1199,1753,8110
北海道,0108,北空知,はい,139,183,183,194,163,110,102,1074,56,80,78,57,53,22,35,381
北海道,0108,北空知,いいえ,183,254,236,265,273,281,345,1837,251,273,307,312,300,369,484,2296
北海道,0109,西胆振,はい,1129,1538,1331,1094,860,613,515,7080,364,602,598,496,386,213,205,2864
北海道,0109,西胆振,いいえ,1366,1870,1685,1502,1494,1592,2029,11538,1444,1871,1837,1664,1549,1869,2714,12948
北海道,0110,東胆振,はい,1879,2318,1883,1538,1139,822,620,10199,543,701,629,533,365,258,210,3239
北海道,0110,東胆振,いいえ,2086,2602,2247,2083,1932,1989,2361,15300,1918,2324,2090,1923,1795,2247,3072,15369
北海道,0111,日高,はい,395,451,403,342,296,195,116,2198,117,163,176,127,112,63,44,802
北海道,0111,日高,いいえ,467,607,550,498,469,448,521,3560,447,582,524,519,466,534,658,3730
北海道,0112,上川中部,はい,2294,2744,2552,2106,1707,1158,905,13466,789,1055,1090,842,632,419,354,5181
北海道,0112,上川中部,いいえ,2961,3830,3510,3264,3378,3105,3547,23595,3361,4145,4045,3505,3354,3651,5225,27286
北海道,0113,上川北部,はい,392,456,395,372,329,256,175,2375,128,186,173,180,134,99,68,968
北海道,0113,上川北部,いいえ,475,640,645,614,673,574,780,4401,554,659,614,630,644,704,1062,4867
北海道,0114,富良野,はい,222,273,287,259,220,185,158,1604,81,113,110,89,84,57,45,579
北海道,0114,富良野,いいえ,342,403,393,448,425,421,552,2984,426,505,519,510,501,553,802,3816
北海道,0115,留萌,はい,231,328,303,255,212,176,104,1609,97,136,129,115,88,80,44,689
北海道,0115,留萌,いいえ,292,417,389,384,396,343,393,2614,303,397,411,388,425,451,644,3019
北海道,0116,宗谷,はい,478,591,531,445,346,242,159,2792,188,186,212,185,119,99,57,1046
北海道,0116,宗谷,いいえ,486,674,555,587,599,573,558,4032,525,589,525,515,510,530,690,3884
北海道,0117,北網,はい,1415,1678,1461,1277,1071,562,427,7891,454,632,575,510,384,228,172,2955
北海道,0117,北網,いいえ,1699,2209,2006,2015,1989,1648,1872,13438,1879,2244,2078,2140,1981,1918,2600,14840
北海道,0118,遠紋,はい,415,517,495,443,343,217,164,2594,115,179,174,174,122,107,60,931
北海道,0118,遠紋,いいえ,433,575,582,599,574,519,668,3950,459,557,654,592,578,651,992,4483
北海道,0119,十勝,はい,2284,2748,2446,2108,1674,1177,959,13396,686,986,900,805,611,406,286,4680
北海道,0119,十勝,いいえ,2799,3612,3372,3361,3397,3133,3630,23304,3146,3855,3840,3616,3419,3694,5017,26587
北海道,0120,釧路,はい,1755,2137,1887,1552,1342,830,553,10056,619,917,863,763,555,344,227,4288
北海道,0120,釧路,いいえ,1707,2212,2228,2067,2064,1924,2230,14432,1916,2388,2259,2015,2018,2291,2772,15659
北海道,0121,根室,はい,501,530,476,429,317,206,127,2586,170,215,206,192,116,83,38,1020
北海道,0121,根室,いいえ,524,679,560,561,537,488,517,3866,594,640,615,570,586,596,648,4249
青森県,0201,津軽地域,はい,2028,2114,1966,1707,1464,883,710,10872,702,825,797,717,545,262,181,4029
青森県,0201,津軽地域,いいえ,2448,2844,2737,2792,2856,2617,2996,19290,3192,3622,3588,3812,3563,3714,4480,25971
青森県,0202,八戸地域,はい,2985,3440,3212,2742,2176,1301,787,16643,809,1026,1076,718,548,239,114,4530
青森県,0202,八戸地域,いいえ,3027,3796,4008,3693,3860,3497,3683,25564,3683,4686,4746,4501,4253,4291,4789,30949
青森県,0203,青森地域,はい,2462,3038,2565,2305,1954,1047,807,14178,849,1045,977,800,600,308,246,4825
青森県,0203,青森地域,いいえ,3102,3792,3788,3755,3685,3190,3768,25080,3837,4634,4296,4298,4006,4079,5411,30561
青森県,0204,西北五地域,はい,795,934,902,947,716,500,330,5124,294,350,387,301,237,90,57,1716
青森県,0204,西北五地域,いいえ,779,1002,1033,1111,1100,1258,1430,7713,1032,1283,1419,1540,1718,1973,2170,11135
青森県,0205,上十三地域,はい,1549,1792,1576,1331,1088,742,507,8585,485,605,501,418,321,158,79,2567
青森県,0205,上十三地域,いいえ,1560,1782,1744,1669,1816,1771,2006,12348,1759,2170,2182,2055,2211,2408,2840,15625
青森県,0206,下北地域,はい,500,599,485,471,412,267,178,2912,191,258,262,171,134,89,42,1147
青森県,0206,下北地域,いいえ,501,645,650,650,699,713,821,4679,600,757,758,723,811,919,1045,5613
岩手県,0301,盛岡,はい,4373,4878,4340,3464,2952,1816,1387,23210,1044,1262,1122,754,566,394,276,5418
岩手県,0301,盛岡,いいえ,5418,6480,6249,5955,5868,5363,6349,41682,6579,7875,7462,6981,6867,7275,8976,52015
岩手県,0302,岩手中部,はい,2403,2563,2165,1822,1520,1089,762,12324,555,684,540,398,318,201,117,2813
岩手県,0302,岩手中部,いいえ,2443,2822,2539,2625,2447,2524,2948,18348,2880,3388,3238,3165,3095,3519,4235,23520
岩手県,0303,胆江,はい,1280,1461,1175,990,929,668,485,6988,296,363,318,205,158,121,91,1552
岩手県,0303,胆江,いいえ,1450,1673,1430,1542,1634,1809,2036,11574,1725,1966,1763,1914,2125,2407,2934,14834
岩手県,0304,両磐,はい,1049,1117,940,878,764,537,409,5694,231,297,231,188,123,84,46,1200
岩手県,0304,両磐,いいえ,1155,1355,1265,1365,1494,1588,1787,10009,1415,1634,1617,1688,1864,2029,2207,12454
岩手県,0305,気仙,はい,434,576,568,524,413,303,213,3031,129,149,165,105,93,37,17,695
岩手県,0305,気仙,いいえ,432,597,631,680,622,655,828,4445,575,772,802,910,848,1056,1244,6207
岩手県,0306,釜石,はい,364,454,407,358,268,184,142,2177,112,128,123,100,76,38,25,602
岩手県,0306,釜石,いいえ,347,423,465,475,454,503,507,3174,425,510,544,549,556,604,818,4006
岩手県,0307,宮古,はい,566,639,675,620,465,345,252,3562,143,165,183,116,94,59,28,788
岩手県,0307,宮古,いいえ,572,650,815,803,762,887,1237,5726,677,870,919,906,1059,1264,1670,7365
岩手県,0308,久慈,はい,433,518,529,404,399,248,191,2722,124,150,149,84,56,45,19,627
岩手県,0308,久慈,いいえ,434,537,552,572,715,733,922,4465,583,712,830,764,939,1059,1235,6122
岩手県,0309,二戸,はい,452,507,500,447,411,338,219,2874,135,164,167,109,89,47,32,743
岩手県,0309,二戸,いいえ,390,493,534,627,662,808,922,4436,598,669,823,813,926,1124,1293,6246
宮城県,0401,仙南,はい,1576,1661,1430,1188,1144,975,728,8702,456,560,461,316,287,176,118,2374
宮城県,0401,仙南,いいえ,1694,1925,1726,1765,1968,2353,2814,14245,1937,2378,2215,2356,2568,3086,3392,17932
宮城県,0403,仙台,はい,14363,16547,14388,10728,8133,5543,4271,73973,3784,4722,4041,2839,2102,1313,1007,19808
宮城県,0403,仙台,いいえ,19602,23438,22372,19309,17459,16415,19596,138191,23871,27648,25562,21859,20209,20922,26442,166513
宮城県,0406,大崎・栗原,はい,2683,2711,2220,2158,1947,1434,1028,14181,743,934,636,498,400,255,120,3586
宮城県,0406,大崎・栗原,いいえ,2702,2910,2613,2708,3198,3534,3934,21599,3253,3564,3519,3643,4117,4669,4868,27633
宮城県,0409,石巻・登米・気仙沼,はい,3109,3371,3029,2601,2364,1762,1383,17619,864,1050,903,685,509,305,187,4503
宮城県,0409,石巻・登米・気仙沼,いいえ,2919,3398,3301,3451,3733,4323,5384,26509,3699,4276,4392,4839,5260,5957,7182,35605
秋田県,0501,大館・鹿角,はい,926,1069,886,862,779,523,312,5357,294,316,297,232,187,84,52,1462
秋田県,0501,大館・鹿角,いいえ,877,1055,1002,1128,1196,1153,1339,7750,1172,1345,1393,1476,1553,1539,1871,10349
秋田県,0502,北秋田,はい,205,281,263,257,201,156,88,1451,64,81,93,55,53,-,-,382
秋田県,0502,北秋田,いいえ,242,287,277,367,380,430,487,2470,301,376,396,417,484,521,633,3128
秋田県,0503,能代・山本,はい,603,671,617,543,510,331,272,3547,174,257,229,181,138,73,30,1082
秋田県,0503,能代・山本,いいえ,584,715,762,836,893,923,1003,5716,792,968,1058,1084,1236,1275,1530,7943
秋田県,0504,秋田周辺,はい,3277,3674,3130,2709,2263,1398,966,17417,771,1072,982,626,484,291,212,4438
秋田県,0504,秋田周辺,いいえ,4216,5254,4973,4906,4895,4352,4737,33333,5388,6157,5793,5482,5327,5434,6662,40243
秋田県,0505,由利本荘・にかほ,はい,838,836,755,663,619,480,301,4492,236,280,230,171,120,-,-,1131
秋田県,0505,由利本荘・にかほ,いいえ,754,847,874,954,1034,1235,1367,7065,1129,1254,1336,1393,1481,1706,1747,10046
秋田県,0506,大仙・仙北,はい,1010,1042,874,798,773,650,425,5572,269,342,276,172,155,84,48,1346
秋田県,0506,大仙・仙北,いいえ,1020,1185,1164,1267,1535,1572,1899,9642,1450,1535,1634,1831,2190,2444,2495,13579
秋田県,0507,横手,はい,791,832,664,666,600,467,359,4379,224,243,165,118,104,55,26,935
秋田県,0507,横手,いいえ,866,925,896,926,1080,1074,1278,7045,1116,1295,1350,1392,1488,1767,1767,10175
秋田県,0508,湯沢・雄勝,はい,496,508,524,474,490,330,256,3078,122,160,143,80,76,-,-,639
秋田県,0508,湯沢・雄勝,いいえ,512,545,570,737,795,906,982,5047,683,790,854,938,1076,1192,1236,6769
山形県,0601,村山,はい,5224,5385,4578,3803,3151,2257,1656,26054,1371,1508,1198,881,737,414,222,6331
山形県,0601,村山,いいえ,6716,7412,7071,6938,7435,7693,8791,52056,8889,9726,9137,9028,9324,9595,9953,65652
山形県,0602,最上,はい,750,827,681,658,644,410,298,4268,233,275,265,169,152,92,35,1221
山形県,0602,最上,いいえ,662,751,731,868,1041,1210,1320,6583,949,1072,1125,1248,1504,1584,1522,9004
山形県,0603,置賜,はい,2208,2301,1978,1675,1451,1098,768,11479,675,700,565,402,328,224,119,3013
山形県,0603,置賜,いいえ,2334,2710,2702,2774,2927,3044,3461,19952,3025,3451,3479,3614,3648,3832,3955,25004
山形県,0604,庄内,はい,2581,2744,2412,2148,1900,1387,1121,14293,672,826,685,454,384,238,131,3390
山形県,0604,庄内,いいえ,3115,3617,3566,3574,3984,4286,4904,27046,4198,4754,4792,4973,5271,5766,6428,36182
福島県,0701,県北,はい,4063,4719,4120,3534,2833,1957,1500,22726,1130,1350,1141,815,607,389,284,5716
福島県,0701,県北,いいえ,5097,6095,6047,5880,6029,6042,7329,42519,6224,7353,7422,7130,7316,7817,9116,52378
福島県,0702,県中,はい,4885,5230,4251,3633,3012,2112,1325,24448,1355,1573,1254,952,784,455,329,6702
福島県,0702,県中,いいえ,5078,6048,5757,5572,5893,5636,6624,40608,6694,7579,7242,7310,7433,7627,8662,52547
福島県,0703,県南,はい,1641,1650,1286,1188,1016,706,504,7991,456,540,394,274,216,138,85,2103
福島県,0703,県南,いいえ,1367,1560,1510,1662,1697,1920,2137,11853,1822,2004,1876,1930,2367,2502,2676,15177
福島県,0706,相双,はい,1146,1366,1100,991,962,816,651,7032,330,416,282,258,238,137,98,1759
福島県,0706,相双,いいえ,1242,1482,1463,1454,1678,2177,2699,12195,1376,1569,1674,1782,2397,3023,3484,15305
福島県,0707,いわき,はい,2818,3293,2829,2262,1751,1150,763,14866,727,962,789,617,483,256,176,4010
福島県,0707,いわき,いいえ,3214,3960,4016,3781,3607,3266,3513,25357,3713,4429,4331,4194,4089,3743,4296,28795
福島県,0708,会津・南会津,はい,2258,2329,2057,1957,1779,1300,1013,12693,747,812,679,524,488,301,195,3746
福島県,0708,会津・南会津,いいえ,2292,2782,2680,3027,3222,3471,4107,21581,2984,3576,3652,4024,4247,4838,5347,28668
茨城県,0801,水戸,はい,3882,4421,3899,3034,2239,1339,859,19673,928,1214,1043,724,491,277,190,4867
茨城県,0801,水戸,いいえ,5370,6622,6559,5614,5072,4574,4735,38546,6020,7210,7108,6395,5530,5519,5973,43755
茨城県,0802,日立,はい,2164,2625,2574,2081,1552,933,641,12570,464,676,604,405,259,157,102,2667
茨城県,0802,日立,いいえ,2517,3531,3966,3431,3055,2790,3273,22563,2640,3569,3985,3379,3102,3036,3644,23355
茨城県,0803,常陸太田・ひたちなか,はい,2785,3399,3306,2651,1833,1166,817,15957,589,765,750,434,321,186,127,3172
茨城県,0803,常陸太田・ひたちなか,いいえ,4179,5200,5434,4952,4475,4243,4769,33252,4429,5455,5800,5159,4831,5081,5795,36550
茨城県,0804,鹿行,はい,2407,2682,2322,1772,1416,995,668,12262,601,747,688,492,343,170,133,3174
茨城県,0804,鹿行,いいえ,2664,3443,3181,2704,2489,2746,3083,20310,2993,3568,3566,3099,3186,3482,3966,23860
茨城県,0805,土浦,はい,2184,2505,2314,1752,1186,890,562,11393,561,755,672,428,329,182,123,3050
茨城県,0805,土浦,いいえ,2787,3592,3443,3061,2684,2640,2997,21204,2890,3784,3743,3344,3126,3094,3834,23815
茨城県,0806,つくば,はい,2696,3001,2476,1781,1303,808,627,12692,617,866,721,464,318,177,112,3275
茨城県,0806,つくば,いいえ,5668,6032,5325,4335,3548,2965,3298,31171,5766,6367,5492,4411,3677,3554,4001,33268
茨城県,0807,取手・竜ヶ崎,はい,3395,4047,3766,2775,2046,1410,1030,18469,826,1216,1080,749,553,305,201,4930
茨城県,0807,取手・竜ヶ崎,いいえ,5397,7125,6534,5587,4810,4879,6422,40754,5853,7215,6877,5986,5528,6053,7726,45238
茨城県,0808,筑西・下妻,はい,2138,2432,2100,1673,1409,985,602,11339,511,699,699,430,271,148,77,2835
茨城県,0808,筑西・下妻,いいえ,2476,3040,2913,2607,2609,2848,2855,19348,2913,3501,3478,3307,3356,3685,3678,23918
茨城県,0809,古河・坂東,はい,1955,2185,2067,1536,1334,872,629,10578,483,669,623,419,318,178,103,2793
茨城県,0809,古河・坂東,いいえ,2282,2795,2806,2380,2281,2223,2610,17377,2421,3084,3085,2676,2725,2998,3360,20349
栃木県,0901,県北,はい,3507,3806,3246,2585,2163,1568,1159,18034,887,1141,975,604,497,296,183,4583
栃木県,0901,県北,いいえ,4415,4998,4769,4221,4415,4825,5569,33212,4687,5485,5288,5009,5310,5995,6658,38432
栃木県,0902,県西,はい,1456,1796,1638,1242,1069,714,498,8413,372,536,494,314,229,154,122,2221
栃木県,0902,県西,いいえ,1684,2213,2262,2119,2149,2161,2485,15073,1999,2523,2558,2437,2496,2655,3119,17787
栃木県,0903,宇都宮,はい,4717,5546,4939,3564,2451,1290,965,23472,1033,1292,1291,783,470,283,202,5354
栃木県,0903,宇都宮,いいえ,7939,8922,8467,7129,5731,4379,4691,47258,7763,8993,8294,6730,5566,4986,6043,48375
栃木県,0904,県東,はい,1536,1634,1281,1079,952,671,505,7658,389,408,346,246,185,122,73,1769
栃木県,0904,県東,いいえ,1758,2061,1879,1730,1765,2095,2332,13620,1789,2193,2023,1914,2237,2618,2837,15611
栃木県,0905,県南,はい,3963,4944,4272,3208,2617,1730,1143,21877,841,1156,1135,736,532,306,188,4894
栃木県,0905,県南,いいえ,5584,7146,6542,5811,5387,5339,5953,41762,6158,7309,7244,6206,6110,6439,7246,46712
栃木県,0906,両毛,はい,2026,2418,2234,1813,1277,872,634,11274,429,622,606,415,267,164,139,2642
栃木県,0906,両毛,いいえ,2709,3419,3422,2961,2691,2516,3042,20760,2671,3451,3470,3170,2952,3251,4049,23014
群馬県,1001,前橋,はい,2666,3098,2866,2232,1737,1127,829,14555,545,757,772,549,393,229,222,3467
群馬県,1001,前橋,いいえ,4296,5242,5060,4425,3947,3800,4523,31293,4466,5659,5606,5072,4468,4876,6177,36324
群馬県,1002,渋川,はい,930,1018,862,678,681,426,316,4911,221,272,265,195,145,108,89,1295
群馬県,1002,渋川,いいえ,1165,1404,1391,1265,1329,1325,1542,9421,1319,1577,1657,1416,1470,1605,1986,11030
群馬県,1003,伊勢崎,はい,2187,2523,2364,1829,1307,811,672,11693,496,680,739,453,263,169,154,2954
群馬県,1003,伊勢崎,いいえ,2849,3631,3478,3043,2762,2561,3127,21451,3134,3875,3813,3242,2963,3326,4483,24836
群馬県,1004,高崎・安中,はい,3188,3988,3683,2791,1935,1267,960,17812,652,1003,957,703,454,282,251,4302
群馬県,1004,高崎・安中,いいえ,5126,6455,6525,5484,4727,4267,5163,37747,5348,6893,6917,5910,5029,5467,7289,42853
群馬県,1005,藤岡,はい,480,611,529,474,335,223,180,2832,96,193,161,110,86,49,43,738
群馬県,1005,藤岡,いいえ,616,875,835,725,731,732,1023,5537,615,860,941,849,834,955,1338,6392
群馬県,1006,富岡,はい,414,555,452,428,359,271,202,2681,85,152,123,91,73,36,42,602
群馬県,1006,富岡,いいえ,669,831,857,867,887,1039,1241,6391,724,986,1020,1002,1057,1297,1589,7675
群馬県,1007,吾妻,はい,318,433,421,356,389,278,240,2435,83,114,105,102,77,49,45,575
群馬県,1007,吾妻,いいえ,395,558,604,619,691,777,970,4614,456,638,746,746,841,910,1184,5521
群馬県,1008,沼田,はい,541,644,622,534,527,424,327,3619,154,222,183,154,158,90,81,1042
群馬県,1008,沼田,いいえ,627,846,925,939,985,1163,1390,6875,790,1090,1066,1170,1275,1490,1760,8641
群馬県,1009,桐生,はい,1169,1399,1364,1039,748,533,574,6826,294,434,427,306,189,152,116,1918
群馬県,1009,桐生,いいえ,1433,1984,2062,1792,1753,1638,2308,12970,1554,2159,2358,1982,1970,2268,3348,15639
群馬県,1010,太田・館林,はい,3602,4094,3568,2613,1809,1251,1169,18106,645,1038,930,576,342,258,224,4013
群馬県,1010,太田・館林,いいえ,4928,5813,5630,4624,3682,3834,5376,33887,4448,5769,5519,4538,4258,5196,7405,37133
埼玉県,1101,南部,はい,6484,7571,7389,5405,3428,2074,1657,34008,1471,2062,2115,1601,1099,621,559,9528
埼玉県,1101,南部,いいえ,10911,12884,12568,9851,7249,5762,7043,66268,10855,12887,12588,10041,7501,6634,9782,70288
埼玉県,1102,南西部,はい,5543,6604,6265,4760,2928,1939,1812,29851,1243,1820,1948,1370,941,645,664,8631
埼玉県,1102,南西部,いいえ,10235,12111,11929,9572,6972,5773,7626,64218,10558,12446,12200,9760,7026,6942,10901,69833
埼玉県,1103,東部,はい,8581,11182,10573,7239,4961,3400,3247,49183,2175,3309,3482,2366,1567,1153,1104,15156
埼玉県,1103,東部,いいえ,13946,17390,16733,13153,9887,9313,13268,93690,14746,18118,17834,13774,11219,12596,19976,108263
埼玉県,1104,さいたま,はい,9419,11281,10897,7939,5337,3042,2432,50347,1736,2523,2537,1788,1197,733,583,11097
埼玉県,1104,さいたま,いいえ,19738,22892,22611,18788,14687,10924,12830,122470,19295,22309,22305,18047,13572,11945,16459,123932
埼玉県,1105,県央,はい,3793,4793,4598,3406,2399,1696,1454,22139,776,1267,1310,871,590,444,406,5664
埼玉県,1105,県央,いいえ,6678,8471,8519,6978,5892,5589,7625,49752,6564,8453,8805,7274,6331,7144,10801,55372
埼玉県,1106,川越比企,はい,5916,7101,6574,4736,3470,2382,2070,32249,1262,1968,1812,1193,919,625,531,8310
埼玉県,1106,川越比企,いいえ,9751,12309,11865,9772,8557,8263,11157,71674,9476,11604,11734,9780,9128,10167,14419,76308
埼玉県,1107,西部,はい,5192,6672,6488,4755,3355,2365,2027,30854,1326,1884,1859,1284,921,619,557,8450
埼玉県,1107,西部,いいえ,8880,11580,11582,10042,8696,8110,10982,69872,9383,11657,11775,10177,8927,9658,13701,75278
埼玉県,1108,利根,はい,4536,5742,5111,3870,3005,2252,1872,26388,1010,1465,1406,943,706,498,449,6477
埼玉県,1108,利根,いいえ,6941,8914,8620,7249,7071,7277,9295,55367,7010,8757,8649,7833,7712,9046,12325,61332
埼玉県,1109,北部,はい,3962,4547,4224,3196,2473,1716,1213,21331,925,1222,1189,840,656,369,229,5430
埼玉県,1109,北部,いいえ,5579,6734,6654,5868,5408,5498,6272,42013,5757,7263,7221,6518,6137,6441,7569,46906
埼玉県,1110,秩父,はい,597,684,721,561,518,362,266,3709,151,234,184,151,115,68,47,950
埼玉県,1110,秩父,いいえ,843,1059,1147,1150,1167,1270,1433,8069,918,1229,1315,1274,1346,1522,1702,9306
千葉県,1201,千葉,はい,6830,8595,8469,6055,4048,2234,1748,37979,1445,2222,2171,1481,992,541,495,9347
千葉県,1201,千葉,いいえ,12293,16064,16969,13530,10118,7462,9590,86026,12561,15952,16845,13036,9653,8872,13254,90173
千葉県,1202,東葛南部,はい,13054,15929,15628,11151,6998,4136,3554,70450,2868,4207,3931,2803,1938,1220,1097,18064
千葉県,1202,東葛南部,いいえ,25086,30374,30545,24198,17122,13274,17825,158424,26053,31282,31400,23945,17466,16791,25492,172429
千葉県,1203,東葛北部,はい,10175,12354,11546,8172,5469,3500,3160,54376,2307,3395,3239,2285,1569,1064,981,14840
千葉県,1203,東葛北部,いいえ,19105,22550,21803,17567,13874,12230,16520,123649,19793,23100,22470,18169,14721,15935,23477,137665
千葉県,1204,印旛,はい,5026,5801,5398,3816,3092,2145,1628,26906,1206,1733,1494,1077,818,515,323,7166
千葉県,1204,印旛,いいえ,7817,9554,9228,7803,7226,7462,8979,58069,8669,10340,10101,8533,8249,8791,10519,65202
千葉県,1205,香取海匝,はい,1794,2126,2028,1620,1448,1080,888,10984,446,689,638,500,351,248,177,3049
千葉県,1205,香取海匝,いいえ,2189,2746,2806,2722,2889,3193,4033,20578,2547,3043,3490,3529,3971,4500,5435,26515
千葉県,1206,山武長生夷隅,はい,2691,3288,3016,2602,2058,1616,1305,16576,737,1026,1011,772,613,359,243,4761
千葉県,1206,山武長生夷隅,いいえ,3490,4529,4672,4336,4643,4989,6179,32838,3930,4833,5258,5144,5402,5997,7210,37774
千葉県,1207,安房,はい,619,734,735,574,473,316,223,3674,211,301,278,182,141,86,62,1261
千葉県,1207,安房,いいえ,863,1154,1237,1050,1141,1158,1356,7959,1127,1471,1511,1293,1319,1473,1808,10002
千葉県,1208,君津,はい,2573,3006,2643,2027,1649,1264,1005,14167,635,884,830,584,391,279,245,3848
千葉県,1208,君津,いいえ,3447,4379,4172,3480,3339,3801,4922,27540,3480,4173,4272,3681,3565,4594,6406,30171
千葉県,1209,市原,はい,1779,2329,2143,1489,1196,1001,763,10700,472,681,617,441,320,216,185,2932
千葉県,1209,市原,いいえ,2561,3324,3276,2801,2528,2995,3622,21107,2758,3520,3523,3010,3037,3699,4739,24286
東京都,1301,区中央部,はい,11557,12844,12330,9289,5327,2202,1576,55125,2477,3046,2844,1948,1281,750,656,13002
東京都,1301,区中央部,いいえ,27580,30149,28396,23613,16050,8266,7310,141364,26453,28201,25690,18650,12017,7804,9732,128547
東京都,1302,区南部,はい,9346,10726,10414,7446,4792,2675,2227,47626,2252,3003,2897,2066,1474,1019,936,13647
東京都,1302,区南部,いいえ,20386,22703,22717,17812,12180,8231,9963,113992,22024,24284,22316,16324,11403,9787,13838,119976
東京都,1303,区西南部,はい,8855,8864,8050,6121,3935,2292,1926,40043,2774,3106,2808,1987,1460,1014,937,14086
東京都,1303,区西南部,いいえ,21712,23768,22455,19809,14270,9542,10872,122428,27167,29743,27735,21674,15428,12129,16312,150188
東京都,1304,区西部,はい,9214,9368,8470,6272,3937,2507,2000,41768,2682,3314,2964,2080,1645,1019,958,14662
東京都,1304,区西部,いいえ,20636,21963,20505,17354,12872,8948,10321,112599,23811,25479,24058,19385,14158,11123,14863,132877
東京都,1305,区西北部,はい,14075,15316,14415,11123,7577,4799,4258,71563,3728,5086,5106,3915,3060,2147,1836,24878
東京都,1305,区西北部,いいえ,29117,31637,30255,25301,20106,15381,18157,169954,32098,35718,34843,28800,22790,19890,27031,201170
東京都,1306,区東北部,はい,9427,11558,10999,8461,5986,4234,4256,54921,2628,3751,4055,3161,2371,1747,1843,19556
東京都,1306,区東北部,いいえ,16929,19895,19443,15562,12009,10253,13538,107629,18707,21767,21627,18091,14099,13676,20104,128071
東京都,1307,区東部,はい,12317,14854,15063,10889,6824,3973,3659,67579,3155,4338,4418,3203,2195,1572,1522,20403
東京都,1307,区東部,いいえ,23967,27840,27782,21748,14644,11179,13900,141060,25803,29493,29073,21174,15119,14005,20916,155583
東京都,1308,西多摩,はい,2633,3294,3387,2465,1762,1463,1371,16375,799,1136,1184,877,617,469,381,5463
東京都,1308,西多摩,いいえ,4040,5182,5756,5027,4315,4211,6248,34779,4319,5683,6120,5301,4779,5482,8508,40192
東京都,1309,南多摩,はい,9063,11161,11392,8444,5430,3617,3485,52592,2205,3348,3359,2449,1778,1269,1154,15562
東京都,1309,南多摩,いいえ,18744,23151,24951,21080,15880,13646,19224,136676,19941,24537,25715,20983,16889,17451,26802,152318
東京都,1310,北多摩西部,はい,4387,5208,5241,4133,2658,1790,1619,25036,1089,1509,1599,1261,866,611,553,7488
東京都,1310,北多摩西部,いいえ,9294,10989,10954,9809,7466,5966,7909,62387,9563,11268,11569,9705,7622,7381,11158,68266
東京都,1311,北多摩南部,はい,6660,7221,7252,5745,3739,2352,2213,35182,1488,2121,2077,1578,1217,790,756,10027
東京都,1311,北多摩南部,いいえ,16868,18504,18629,16319,11947,9173,11884,103324,18607,20525,20621,16822,12887,11699,16340,117501
東京都,1312,北多摩北部,はい,4658,5294,5383,4372,2978,1905,1798,26388,1069,1543,1635,1262,896,667,616,7688
東京都,1312,北多摩北部,いいえ,10178,11930,12164,10850,8559,7038,9084,69803,11097,12933,13549,11835,9514,8990,13019,80937
東京都,1313,島しょ,はい,164,182,184,147,122,95,90,984,60,71,63,51,52,33,17,347
東京都,1313,島しょ,いいえ,225,289,269,267,217,259,319,1845,295,311,310,221,261,314,408,2120
神奈川県,1404,川崎北部,はい,6032,6724,6894,5131,3022,1665,1294,30762,1316,1749,1840,1347,907,530,440,8129
神奈川県,1404,川崎北部,いいえ,13145,15203,15412,13234,8803,5731,6176,77704,13985,15840,16015,12399,8487,6216,7936,80878
神奈川県,1405,川崎南部,はい,5699,6726,6174,4385,2737,1555,1027,28303,1184,1693,1650,1185,756,448,325,7241
神奈川県,1405,川崎南部,いいえ,11951,13486,12221,9248,6297,4013,3963,61179,11612,12109,11023,8137,5441,3947,4789,57058
神奈川県,1406,横須賀・三浦,はい,3851,5328,5361,4057,2961,1808,1512,24878,962,1590,1721,1186,903,568,464,7394
神奈川県,1406,横須賀・三浦,いいえ,7142,9994,11054,9883,7998,6092,7563,59726,7981,10634,11373,9296,7344,6868,9595,63091
神奈川県,1407,湘南東部,はい,5060,6068,5836,4523,2845,1593,1423,27348,1020,1524,1532,1058,739,465,423,6761
神奈川県,1407,湘南東部,いいえ,10064,12451,13098,10966,8017,5689,7969,68254,10631,12761,12667,10002,7502,7082,11568,72213
神奈川県,1408,湘南西部,はい,3881,4812,4744,3593,2505,1598,1325,22458,922,1394,1394,917,658,416,368,6069
神奈川県,1408,湘南西部,いいえ,6901,8548,8833,7762,6173,5264,7372,50853,6885,8662,8730,7301,6019,6215,9479,53291
神奈川県,1409,県央,はい,6321,8150,8057,5781,3717,2191,1913,36130,1451,2246,2310,1506,1066,585,520,9684
神奈川県,1409,県央,いいえ,11392,13747,13852,11617,8678,6661,9379,75326,10252,13014,12962,10327,8003,8061,13427,76046
神奈川県,1410,相模原,はい,5020,6112,6157,4514,2959,1638,1268,27668,1250,1835,1799,1299,848,497,358,7886
神奈川県,1410,相模原,いいえ,9136,11090,11213,9612,7065,5400,6557,60073,8784,10563,10917,9024,6721,5856,8529,60394
神奈川県,1411,県西,はい,2324,2919,2957,2304,1620,946,807,13877,555,867,825,574,464,295,243,3823
神奈川県,1411,県西,いいえ,4286,5328,5516,5081,3882,2963,3958,31014,3823,4836,5132,4197,3561,3611,5253,30413
神奈川県,1412,横浜,はい,25751,31569,32025,23956,15201,8049,5753,142304,5502,8080,8074,5816,3909,2132,1539,35052
神奈川県,1412,横浜,いいえ,53813,65190,68976,58640,42343,28812,30834,348608,54884,66294,69261,54497,38574,29359,36068,348937
新潟県,1501,下越,はい,1865,1951,1830,1599,1411,996,807,10459,494,615,591,425,321,178,129,2753
新潟県,1501,下越,いいえ,2096,2521,2615,2592,2543,2804,3519,18690,2630,3181,3251,3128,3252,3778,4538,23758
新潟県,1502,新潟,はい,7634,9209,8066,6388,4977,3200,2394,41868,1793,2487,2095,1574,1213,795,540,10497
新潟県,1502,新潟,いいえ,11558,13876,13122,11719,10365,9628,11407,81675,12744,15477,14497,13138,11725,11824,15428,94833
新潟県,1503,県央,はい,1872,2197,2054,1606,1322,952,732,10735,382,647,529,385,279,186,80,2488
新潟県,1503,県央,いいえ,2646,3243,3169,2963,2765,2695,3020,20501,3014,3690,3743,3480,3207,3414,3871,24419
新潟県,1504,中越,はい,4070,4554,3958,3298,2771,1943,1423,22017,938,1251,969,683,564,292,237,4934
新潟県,1504,中越,いいえ,5512,6506,6313,5827,5503,5061,6586,41308,6581,7896,7535,7068,6695,7030,8905,51710
新潟県,1505,魚沼,はい,1404,1531,1313,1208,1145,937,741,8279,369,501,423,320,303,201,107,2224
新潟県,1505,魚沼,いいえ,1742,2003,1970,1955,2210,2571,3095,15546,2237,2533,2528,2482,2581,3113,3400,18874
新潟県,1506,上越,はい,2407,2722,2485,2139,1816,1263,1030,13862,546,756,618,423,356,206,130,3035
新潟県,1506,上越,いいえ,3196,3920,3766,3581,3603,3575,4418,26059,3670,4611,4451,4244,4026,4362,5364,30728
新潟県,1507,佐渡,はい,397,410,420,381,396,319,255,2578,84,131,107,59,70,62,36,549
新潟県,1507,佐渡,いいえ,517,588,669,690,735,770,1052,5021,643,715,735,782,918,976,1256,6025
富山県,1601,新川,はい,982,1289,1164,913,701,477,400,5926,218,356,286,203,113,94,68,1338
富山県,1601,新川,いいえ,1438,1831,1783,1513,1506,1368,1645,11084,1632,2169,2181,2029,1744,1829,2693,14277
富山県,1602,富山,はい,4104,5281,4801,3484,2547,1611,1228,23056,833,1278,1193,846,533,301,226,5210
富山県,1602,富山,いいえ,6892,8678,8266,6740,5663,4688,5420,46347,7452,9385,9009,7500,6343,5842,7597,53128
富山県,1603,高岡,はい,2647,3430,3064,2263,1743,1300,1320,15767,517,834,729,447,346,214,234,3321
富山県,1603,高岡,いいえ,3878,5067,4658,4014,3489,3378,4830,29314,4121,5528,5579,4722,4409,4901,7601,36861
富山県,1604,砺波,はい,939,1257,1109,862,807,605,606,6185,167,256,222,153,123,98,51,1070
富山県,1604,砺波,いいえ,1598,1964,1722,1598,1606,1637,2417,12542,1844,2397,2282,2192,2212,2528,3453,16908
石川県,1701,南加賀,はい,1706,2329,1965,1506,1051,738,758,10053,369,632,491,406,301,221,212,2632
石川県,1701,南加賀,いいえ,2769,3655,3182,2786,2504,2144,3044,20084,3255,4172,4097,3545,3075,3000,4428,25572
石川県,1702,石川中央,はい,5715,7134,6443,4690,3471,2316,1964,31733,1281,1994,1780,1315,991,635,614,8610
石川県,1702,石川中央,いいえ,10085,12583,11418,9322,8042,6845,8820,67115,11357,14058,13069,10759,9363,8921,12567,80094
石川県,1703,能登中部,はい,824,1113,953,770,659,493,495,5307,178,285,252,194,158,100,93,1260
石川県,1703,能登中部,いいえ,1155,1509,1419,1374,1377,1490,2030,10354,1440,2021,1897,1837,1878,2208,2913,14194
石川県,1704,能登北部,はい,333,431,421,389,401,311,307,2593,96,133,136,91,80,65,43,644
石川県,1704,能登北部,いいえ,419,616,568,647,721,843,1176,4990,601,752,847,882,1042,1194,1691,7009
福井県,1801,福井・坂井,はい,3071,3704,3353,2749,2030,1251,966,17124,647,912,748,582,435,264,196,3784
福井県,1801,福井・坂井,いいえ,5082,6118,5771,5037,4625,3689,4008,34330,5810,7132,7052,6238,5424,4585,5135,41376
福井県,1802,奥越,はい,459,487,473,388,339,252,194,2592,104,103,108,80,54,34,32,515
福井県,1802,奥越,いいえ,559,696,596,616,665,709,799,4640,761,872,875,922,918,964,1058,6370
福井県,1803,丹南,はい,1577,1824,1545,1204,943,554,469,8116,305,386,308,229,162,76,62,1528
福井県,1803,丹南,いいえ,2444,2837,2530,2274,1970,1683,1906,15644,2735,3207,3168,2760,2470,2125,2609,19074
福井県,1804,嶺南,はい,957,1108,1040,843,725,508,375,5556,177,252,210,160,114,72,52,1037
福井県,1804,嶺南,いいえ,1632,1872,1786,1710,1636,1491,1681,11808,1681,2203,1975,1909,1735,1827,2198,13528
山梨県,1901,中北,はい,3875,4546,4326,3270,2395,1694,1209,21315,934,1304,1308,1004,732,441,311,6034
山梨県,1901,中北,いいえ,5597,6844,6803,6419,5494,5331,6183,42671,6600,8271,8058,7394,6814,7033,8210,52380
山梨県,1902,峡東,はい,1008,1266,1262,944,732,570,499,6281,316,393,439,335,221,160,106,1970
山梨県,1902,峡東,いいえ,1389,1757,1898,1724,1732,1704,2058,12262,1738,2204,2338,2164,2078,2287,2553,15362
山梨県,1903,峡南,はい,370,418,466,383,396,291,246,2570,82,128,133,105,82,52,44,626
山梨県,1903,峡南,いいえ,458,599,617,682,727,869,1063,5015,563,745,824,912,951,1111,1358,6464
山梨県,1904,富士・東部,はい,1346,1588,1607,1455,1132,716,563,8407,375,475,475,439,296,180,82,2322
山梨県,1904,富士・東部,いいえ,1677,1980,2363,2434,2268,2282,2450,15454,1959,2460,2913,2857,2778,2694,2946,18607
長野県,2001,佐久,はい,1675,1772,1639,1329,1080,797,691,8983,385,515,437,308,212,152,109,2118
長野県,2001,佐久,いいえ,2331,2728,2762,2666,2628,2603,3290,19008,2761,3094,3247,3113,3070,3269,4078,22632
長野県,2002,上小,はい,1481,1778,1674,1200,918,604,456,8111,333,487,417,298,219,122,93,1969
長野県,2002,上小,いいえ,2087,2781,2556,2407,2149,2131,2473,16584,2332,2974,3089,2791,2658,2623,3287,19754
長野県,2003,諏訪,はい,1428,1891,1731,1216,851,658,530,8305,331,514,459,243,178,124,101,1950
長野県,2003,諏訪,いいえ,2279,2837,2861,2454,2146,2013,2747,17337,2488,3427,3361,2897,2664,2634,3725,21196
長野県,2004,上伊那,はい,1578,1944,1682,1272,1018,671,604,8769,310,464,373,237,169,104,84,1741
長野県,2004,上伊那,いいえ,2383,3015,2804,2537,2445,2280,2884,18348,2738,3500,3439,3091,2895,2942,3862,22467
長野県,2005,飯伊,はい,1251,1472,1400,1131,817,659,443,7173,290,346,309,249,168,87,64,1513
長野県,2005,飯伊,いいえ,1975,2261,2240,2138,2015,2048,2304,14981,2205,2744,2705,2639,2631,2607,2717,18248
長野県,2006,木曽,はい,177,209,196,233,161,143,119,1238,39,33,37,36,36,11,12,204
長野県,2006,木曽,いいえ,230,327,342,377,365,461,622,2724,292,323,370,417,450,515,748,3115
長野県,2007,松本,はい,3338,4046,3850,2698,1942,1331,1150,18355,610,929,899,530,445,238,201,3852
長野県,2007,松本,いいえ,5639,7082,6811,5989,4914,4650,5652,40737,5867,7500,7495,6516,5712,5753,7799,46642
長野県,2008,大北,はい,373,493,475,396,282,248,235,2502,84,154,115,83,62,37,31,566
長野県,2008,大北,いいえ,651,834,857,859,834,852,1237,6124,667,932,990,1012,953,1016,1443,7013
長野県,2009,長野,はい,4489,5189,4972,3730,2676,1733,1568,24357,827,1173,995,698,473,330,274,4770
長野県,2009,長野,いいえ,6746,8607,8535,7602,6845,6309,7967,52611,7463,9753,9968,8919,7768,8140,11008,63019
長野県,2010,北信,はい,649,742,739,652,489,418,333,4022,150,206,180,124,101,51,42,854
長野県,2010,北信,いいえ,901,1083,1064,1107,1146,1162,1450,7913,1156,1432,1404,1515,1471,1498,1682,10158
岐阜県,2101,岐阜,はい,5511,6695,6223,4623,3413,2334,2163,30962,999,1457,1376,1014,757,538,493,6634
岐阜県,2101,岐阜,いいえ,10143,12914,12640,10524,8635,7589,9925,72370,10248,13214,13602,11276,9758,9865,13861,81824
岐阜県,2102,西濃,はい,2640,3242,3043,2280,1916,1240,1105,15466,469,646,528,397,310,187,144,2681
岐阜県,2102,西濃,いいえ,4439,5596,5343,4743,4121,3835,4541,32618,4429,5708,5733,5191,4872,4841,6324,37098
岐阜県,2103,中濃,はい,2866,3342,2855,2277,1885,1360,1106,15691,484,697,613,454,340,242,168,2998
岐阜県,2103,中濃,いいえ,4406,5506,5273,4497,4424,4303,5244,33653,4468,5618,5744,5353,5259,5330,6204,37976
岐阜県,2104,東濃,はい,2622,3117,2808,2362,1834,1242,916,14901,471,672,622,458,356,226,154,2959
岐阜県,2104,東濃,いいえ,3913,5016,4960,4573,4121,3854,4512,30949,4037,5192,5512,5177,5021,4762,6122,35823
岐阜県,2105,飛騨,はい,1208,1525,1289,1113,860,676,666,7337,228,385,329,247,187,153,132,1661
岐阜県,2105,飛騨,いいえ,1642,2061,2137,1946,1972,1833,2559,14150,1979,2550,2629,2513,2415,2556,3391,18033
静岡県,2201,賀茂,はい,328,399,460,343,293,208,175,2206,81,132,123,111,105,64,53,669
静岡県,2201,賀茂,いいえ,355,537,655,622,578,660,857,4264,427,619,706,651,637,843,1200,5083
静岡県,2202,熱海伊東,はい,422,636,621,530,480,362,413,3464,159,256,278,271,213,185,259,1621
静岡県,2202,熱海伊東,いいえ,539,888,1050,970,987,996,1642,7072,720,1003,1218,1105,1168,1392,2539,9145
静岡県,2203,駿東田方,はい,5317,6381,5888,4678,3344,2223,1868,29699,1225,1754,1690,1255,887,611,479,7901
静岡県,2203,駿東田方,いいえ,7674,9690,9988,8741,7459,6656,8399,58607,7919,10230,10408,9213,8209,8524,11940,66443
静岡県,2204,富士,はい,3677,4294,4120,3109,2187,1295,985,19667,788,1233,1074,720,523,291,193,4822
静岡県,2204,富士,いいえ,4647,5741,5895,5237,4442,3813,4411,34186,4541,5762,6174,5544,4700,4552,5654,36927
静岡県,2205,静岡,はい,5258,6463,6139,4822,3375,2135,1643,29835,1059,1666,1547,1078,742,506,387,6985
静岡県,2205,静岡,いいえ,8521,11171,11487,9657,8571,6943,8316,64666,9404,11645,12285,10458,8873,7824,9830,70319
静岡県,2206,志太榛原,はい,3693,4372,3825,2980,2305,1378,1111,19664,753,980,850,584,470,239,207,4083
静岡県,2206,志太榛原,いいえ,5547,6784,6648,5912,5627,5093,6126,41737,6233,7606,7526,6832,6513,6284,8005,48999
静岡県,2207,中東遠,はい,4494,4927,4049,3226,2374,1542,1220,21832,829,1085,809,532,437,231,177,4100
静岡県,2207,中東遠,いいえ,6663,7680,6938,6058,6067,5515,6423,45344,6893,8001,7525,6670,6819,6909,7945,50762
静岡県,2208,西部,はい,6971,7905,7238,5524,4016,2256,1743,35653,1259,1858,1553,988,738,442,302,7140
静岡県,2208,西部,いいえ,12305,14667,14571,12696,10924,8671,9796,83630,12393,14980,15522,12772,11224,9870,11645,88406
愛知県,2302,海部,はい,2300,3184,3044,2241,1478,1034,1007,14288,433,722,663,425,372,225,256,3096
愛知県,2302,海部,いいえ,3948,5422,5529,4231,3253,2671,3792,28846,3698,5127,5225,4209,3480,3594,5969,31302
愛知県,2304,尾張東部,はい,3521,4258,4069,2890,1927,1195,1181,19041,534,846,767,538,414,264,269,3632
愛知県,2304,尾張東部,いいえ,7582,9093,8961,6976,5348,3960,5432,47352,7324,8756,8698,6723,5261,5157,7800,49719
愛知県,2305,尾張西部,はい,3401,4480,4434,3223,2144,1574,1588,20844,627,1004,933,734,509,385,422,4614
愛知県,2305,尾張西部,いいえ,6789,8970,8770,7363,5641,4915,6786,49234,6969,9230,9595,7809,6404,6559,10158,56724
愛知県,2306,尾張北部,はい,4984,6410,6176,4375,2895,1880,1871,28591,859,1347,1219,849,629,434,437,5774
愛知県,2306,尾張北部,いいえ,9561,12338,12056,9510,7131,6046,8044,64686,9074,11959,12088,9237,7395,7754,11793,69300
愛知県,2307,知多半島,はい,5314,6418,5830,4344,3035,1949,1864,28754,864,1275,1196,851,646,434,366,5632
愛知県,2307,知多半島,いいえ,9379,11643,10881,9140,7003,6119,8511,62676,9105,11249,10964,8947,7620,7926,11912,67723
愛知県,2308,西三河北部,はい,4731,5305,4899,3653,2455,1237,1115,23395,618,870,757,520,383,213,186,3547
愛知県,2308,西三河北部,いいえ,8147,9340,9544,7905,5960,4027,5206,50129,7237,8873,8896,6669,5244,5114,6916,48949
愛知県,2309,西三河南部西,はい,6897,7854,7449,5534,3472,1892,1647,34745,952,1314,1228,855,534,351,280,5514
愛知県,2309,西三河南部西,いいえ,11249,12982,12709,10687,8008,5784,7398,68817,10229,12235,12261,10045,7481,7140,9337,68728
愛知県,2310,西三河南部東,はい,3884,4398,4067,3018,2089,1354,1221,20031,586,800,687,448,409,280,226,3436
愛知県,2310,西三河南部東,いいえ,6860,7740,7488,6344,5217,4400,5916,43965,6568,7671,7361,6274,5465,5647,7697,46683
愛知県,2311,東三河北部,はい,433,490,438,389,306,256,203,2515,61,79,74,61,44,30,31,380
愛知県,2311,東三河北部,いいえ,625,717,732,668,741,734,1016,5233,576,773,749,793,927,972,1295,6085
愛知県,2312,東三河南部,はい,5553,6506,6096,4523,3234,1926,1488,29326,855,1274,1159,845,625,372,288,5418
愛知県,2312,東三河南部,いいえ,9052,11002,10716,9019,7609,6074,7258,60730,8545,10568,10770,9160,8130,7498,10003,64674
愛知県,2313,名古屋・尾張中部,はい,18381,21473,20305,15076,10088,6285,5434,97042,3337,4651,4619,3314,2557,1632,1542,21652
愛知県,2313,名古屋・尾張中部,いいえ,37558,42939,42419,34854,26415,18487,20861,223533,35343,41011,40998,33064,25230,20835,27391,223872
三重県,2401,北勢,はい,6791,8590,7877,5966,3976,2550,2434,38184,1323,1813,1596,1111,806,491,451,7591
三重県,2401,北勢,いいえ,10887,14016,14193,12156,9772,8104,10950,80078,11097,14348,14667,12389,10398,10765,15563,89227
三重県,2402,中勢伊賀,はい,3338,3793,3446,2714,2102,1501,1289,18183,680,833,772,575,463,266,233,3822
三重県,2402,中勢伊賀,いいえ,5252,6555,6462,5598,5356,4826,5877,39926,5645,6967,6990,6248,6041,6207,8189,46287
三重県,2403,南勢志摩,はい,3085,3896,3423,2859,2180,1634,1444,18521,681,1012,853,713,508,289,261,4317
三重県,2403,南勢志摩,いいえ,4611,5918,6061,5628,5194,4984,6584,38980,5359,7000,7263,6701,6526,7236,9642,49727
三重県,2404,東紀州,はい,393,522,464,444,330,300,284,2737,93,162,133,139,97,59,66,749
三重県,2404,東紀州,いいえ,518,737,783,739,782,863,1111,5533,620,784,895,900,1005,1155,1771,7130
滋賀県,2501,大津,はい,2287,2617,2465,1910,1358,902,747,12286,450,649,614,418,316,192,174,2813
滋賀県,2501,大津,いいえ,4810,6000,5679,4973,4263,3446,4115,33286,5710,6667,6572,5554,4732,3932,5191,38358
滋賀県,2502,湖南,はい,2757,3163,2702,1966,1315,832,772,13507,494,677,550,380,250,134,147,2632
滋賀県,2502,湖南,いいえ,5359,6219,5594,4472,3246,2763,3554,31207,5924,6790,6054,4421,3616,3606,5273,35684
滋賀県,2503,甲賀,はい,1340,1456,1236,1004,802,577,494,6909,245,351,254,164,177,97,74,1362
滋賀県,2503,甲賀,いいえ,1802,2164,2104,1773,1733,1594,2109,13279,1928,2226,2152,2091,2135,2126,2837,15495
滋賀県,2504,東近江,はい,2044,2089,1717,1391,1110,775,649,9775,353,453,349,254,188,121,92,1810
滋賀県,2504,東近江,いいえ,2801,3217,2993,2599,2519,2322,2885,19336,3211,3576,3421,3247,3108,3068,3731,23362
滋賀県,2505,湖東,はい,1256,1420,1194,940,744,466,418,6438,275,342,284,168,139,78,70,1356
滋賀県,2505,湖東,いいえ,1947,2231,2041,1668,1576,1533,1794,12790,2026,2409,2322,2066,2004,2006,2362,15195
滋賀県,2506,湖北,はい,1159,1431,1275,973,781,478,374,6471,268,299,219,143,106,60,41,1136
滋賀県,2506,湖北,いいえ,1856,2110,2020,1919,1749,1546,1739,12939,2058,2420,2564,2401,2212,2082,2291,16028
滋賀県,2507,湖西,はい,286,308,337,299,279,181,142,1832,72,96,79,59,53,32,20,411
滋賀県,2507,湖西,いいえ,423,551,610,579,641,550,675,4029,544,659,753,798,775,688,885,5102
京都府,2601,丹後,はい,645,799,784,619,580,377,318,4122,174,196,175,137,89,45,30,846
京都府,2601,丹後,いいえ,886,1251,1267,1305,1232,1145,1402,8488,1107,1601,1696,1627,1558,1502,1787,10878
京都府,2602,中丹,はい,1305,1627,1373,1103,878,618,559,7463,292,471,372,287,220,125,118,1885
京都府,2602,中丹,いいえ,1921,2528,2461,2242,2093,1860,2447,15552,2118,2820,2809,2439,2440,2251,3412,18289
京都府,2603,南丹,はい,913,1039,896,754,665,496,442,5205,226,338,289,211,166,109,76,1415
京都府,2603,南丹,いいえ,1394,1669,1653,1485,1504,1446,1825,10976,1523,1902,1977,1892,1932,1790,2387,13403
京都府,2604,京都・乙訓,はい,8818,10772,10165,7578,5473,3348,2941,49095,2174,3178,3015,2321,1689,1004,855,14236
京都府,2604,京都・乙訓,いいえ,18531,22685,22362,18602,15098,10931,13048,121257,20766,24589,24057,19754,15026,12418,16636,133246
京都府,2605,山城北,はい,2779,3689,3311,2439,1636,1164,1247,16265,652,984,859,673,513,341,329,4351
京都府,2605,山城北,いいえ,5054,6886,6427,5156,4320,4046,5995,37884,5393,7141,6779,5589,4825,5502,9135,44364
京都府,2606,山城南,はい,739,942,762,567,419,306,319,4054,135,176,162,109,82,55,57,776
京都府,2606,山城南,いいえ,1703,2077,1990,1599,1386,1199,1595,11549,1691,2100,1914,1650,1389,1470,2141,12355
大阪府,2701,豊能,はい,5979,7156,6973,5227,3554,2246,2004,33139,1106,1718,1750,1341,842,615,588,7960
大阪府,2701,豊能,いいえ,13976,16711,16747,13360,10109,7706,10368,88977,14829,17809,18026,13985,10644,9914,14531,99738
大阪府,2702,三島,はい,4330,5424,5501,3701,2673,1706,1484,24819,975,1436,1402,944,741,437,360,6295
大阪府,2702,三島,いいえ,9293,11940,11314,8631,6765,5410,7436,60789,9884,12308,12030,8854,7199,7072,10723,68070
大阪府,2703,北河内,はい,6468,8370,8404,6200,4106,2676,2535,38759,1525,2429,2517,1812,1210,761,694,10948
大阪府,2703,北河内,いいえ,11226,15190,15243,12283,9568,7758,10264,81532,12083,15912,16687,13068,9974,9953,15929,93606
大阪府,2704,中河内,はい,4755,6064,6004,4519,3079,1848,1726,27995,1204,1807,1996,1587,1086,640,518,8838
大阪府,2704,中河内,いいえ,7650,10408,10970,8742,6581,5052,6735,56138,7736,10711,11411,9559,7389,6865,10395,64066
大阪府,2705,南河内,はい,2854,3716,3818,3167,2348,1615,1475,18993,755,1133,1229,966,709,440,445,5677
大阪府,2705,南河内,いいえ,4797,6661,7245,6333,5608,5206,7111,42961,5336,7224,8027,7075,6186,6816,10315,50979
大阪府,2706,堺市,はい,4695,6399,6148,4341,2919,1812,1560,27874,1310,2060,1925,1471,1006,619,441,8832
大阪府,2706,堺市,いいえ,8412,11362,11120,8633,6623,5180,7137,58467,9133,11688,11444,8822,6729,6752,10678,65246
大阪府,2707,泉州,はい,4991,6531,6538,5040,3428,2335,2039,30902,1308,2046,2032,1520,1033,611,505,9055
大阪府,2707,泉州,いいえ,7940,11164,11541,9317,7565,6425,8375,62327,8924,12070,12563,10189,8429,8738,12026,72939
大阪府,2708,大阪市,はい,19354,22702,21986,16370,10777,5943,4364,101496,6674,8702,8561,6734,4215,1827,1329,38042
大阪府,2708,大阪市,いいえ,35180,41628,41810,33034,24129,15415,15759,206955,39926,45380,45012,36491,25825,17751,21045,231430
兵庫県,2801,神戸,はい,9369,11653,10765,8056,5930,3627,2986,52386,1972,2711,2526,1970,1440,782,678,12079
兵庫県,2801,神戸,いいえ,18895,23643,24163,20187,17250,13631,15979,133748,20540,25347,25152,21067,17673,15426,20362,145567
兵庫県,2804,東播磨,はい,4912,5655,5276,3886,2765,1774,1342,25610,831,1298,1103,712,493,234,208,4879
兵庫県,2804,東播磨,いいえ,8995,10950,10748,8607,7201,5807,6866,59174,8528,10442,10660,8512,6843,6672,8718,60375
兵庫県,2805,北播磨,はい,1803,2279,2164,1679,1354,937,745,10961,349,525,373,292,199,106,61,1905
兵庫県,2805,北播磨,いいえ,2750,3336,3241,3045,2718,2685,3275,21050,3033,3828,4016,3679,3466,3414,4196,25632
兵庫県,2808,但馬,はい,1171,1368,1151,1043,961,702,570,6966,201,305,240,153,177,84,43,1203
兵庫県,2808,但馬,いいえ,1636,2079,2040,1859,2110,2073,2475,14272,1927,2506,2695,2675,2708,2767,3140,18418
兵庫県,2809,丹波,はい,771,884,750,608,557,409,301,4280,155,187,148,119,114,41,33,797
兵庫県,2809,丹波,いいえ,1020,1218,1140,1071,1181,1079,1229,7938,1154,1412,1482,1446,1501,1389,1512,9896
兵庫県,2810,淡路,はい,674,856,777,666,559,485,361,4378,139,211,180,159,110,71,42,912
兵庫県,2810,淡路,いいえ,1169,1416,1356,1287,1391,1441,1763,9823,1517,1827,1785,1664,1950,1984,2361,13088
兵庫県,2811,阪神,はい,9622,12543,12295,9292,6399,4080,3621,57852,1945,3109,2970,2215,1630,930,824,13623
兵庫県,2811,阪神,いいえ,20430,26549,27708,22950,17718,14280,18551,148186,22331,28578,29667,23512,18480,17149,24834,164551
兵庫県,2812,播磨姫路,はい,5664,6874,6053,4790,3615,2463,2163,31622,1034,1472,1248,808,569,328,299,5758
兵庫県,2812,播磨姫路,いいえ,9077,11526,10887,9526,8394,7402,9426,66238,9189,12208,11856,10487,9268,9752,13422,76182
奈良県,2901,奈良,はい,1657,2103,2120,1684,1277,821,695,10357,392,529,566,422,296,202,189,2596
奈良県,2901,奈良,いいえ,3702,4838,5059,4439,3832,3236,4265,29371,4370,5598,5928,5001,4162,4395,6202,35656
奈良県,2902,東和,はい,1156,1355,1294,1061,788,607,510,6771,300,381,372,301,186,91,93,1724
奈良県,2902,東和,いいえ,1748,2367,2406,2238,2072,1807,2340,14978,2052,2546,2659,2484,2358,2395,3165,17659
奈良県,2903,西和,はい,1792,2284,2174,1693,1204,775,799,10721,388,575,494,388,280,163,172,2460
奈良県,2903,西和,いいえ,3784,5031,4987,4072,3424,3023,4223,28544,4232,5367,5388,4430,3780,4120,6354,33671
奈良県,2904,中和,はい,2265,2697,2605,1917,1358,886,865,12593,523,675,685,525,374,212,155,3149
奈良県,2904,中和,いいえ,3785,5017,5101,4442,3683,3215,3886,29129,4345,5424,5741,4834,4104,4087,5634,34169
奈良県,2905,南和,はい,273,339,350,360,328,219,183,2052,87,128,108,124,62,38,32,579
奈良県,2905,南和,いいえ,398,569,653,650,756,703,723,4452,536,674,711,836,913,868,973,5511
和歌山県,3001,和歌山,はい,2623,3244,3052,2387,1779,1146,1075,15306,577,798,866,762,466,268,262,3999
和歌山県,3001,和歌山,いいえ,4356,5556,5433,4709,4354,3722,4855,32985,4497,5860,5907,5287,4715,4948,7252,38466
和歌山県,3002,那賀,はい,731,871,842,661,527,369,281,4282,167,263,255,219,144,57,54,1159
和歌山県,3002,那賀,いいえ,1037,1437,1430,1279,1220,1117,1386,8906,1188,1515,1614,1537,1406,1470,1858,10588
和歌山県,3003,橋本,はい,461,560,524,469,428,322,231,2995,117,149,152,123,101,52,36,730
和歌山県,3003,橋本,いいえ,664,926,865,859,912,930,1128,6284,791,1048,1094,1066,1136,1189,1509,7833
和歌山県,3004,有田,はい,407,485,463,350,310,224,182,2421,98,145,144,113,70,39,25,634
和歌山県,3004,有田,いいえ,592,796,723,717,661,681,881,5051,782,861,963,872,884,960,1096,6418
和歌山県,3005,御坊,はい,398,465,431,360,287,214,168,2323,84,120,110,78,64,37,26,519
和歌山県,3005,御坊,いいえ,594,783,672,664,693,705,801,4912,678,821,838,832,802,934,1000,5905
和歌山県,3006,田辺,はい,759,992,856,713,604,391,269,4584,210,302,271,249,156,82,67,1337
和歌山県,3006,田辺,いいえ,1139,1448,1442,1378,1346,1226,1443,9422,1405,1714,1740,1753,1640,1593,1926,11771
和歌山県,3007,新宮,はい,288,428,392,332,287,184,174,2085,76,106,115,84,62,41,30,514
和歌山県,3007,新宮,いいえ,452,607,638,603,627,593,894,4414,482,616,677,730,756,896,1268,5425
鳥取県,3101,東部,はい,1639,1862,1507,1362,1119,862,594,8945,360,372,304,202,160,109,67,1574
鳥取県,3101,東部,いいえ,2712,3152,2747,2581,2599,2413,2733,18937,3094,3646,3407,3244,3217,3311,3723,23642
鳥取県,3102,中部,はい,721,693,672,614,535,356,270,3861,147,206,141,105,81,58,31,769
鳥取県,3102,中部,いいえ,1002,1159,1067,1009,1024,1076,1224,7561,1189,1466,1336,1328,1368,1472,1663,9822
鳥取県,3103,西部,はい,1549,1734,1550,1275,1068,699,529,8404,305,421,322,264,193,128,83,1716
鳥取県,3103,西部,いいえ,2425,2915,2702,2501,2454,2196,2484,17677,2902,3386,3206,2976,2816,2708,3571,21565
島根県,3201,松江,はい,1755,2032,1794,1363,1112,830,623,9509,335,438,333,227,172,98,100,1703
島根県,3201,松江,いいえ,2985,3662,3516,3120,2976,2689,3434,22382,3552,4454,4178,3734,3536,3539,4835,27828
島根県,3202,雲南,はい,387,507,383,304,332,245,193,2351,59,78,66,45,45,26,19,338
島根県,3202,雲南,いいえ,578,664,581,636,771,814,998,5042,745,881,812,845,904,896,1157,6240
島根県,3203,出雲,はい,1370,1533,1339,1023,854,634,505,7258,244,323,236,134,95,95,65,1192
島根県,3203,出雲,いいえ,2122,2496,2189,2036,2073,1964,2463,15343,2638,3013,2674,2582,2505,2644,3129,19185
島根県,3204,大田,はい,407,411,337,325,324,274,241,2319,79,107,81,48,58,39,33,445
島根県,3204,大田,いいえ,468,613,551,504,636,777,1033,4582,626,781,724,752,938,1089,1388,6298
島根県,3205,浜田,はい,561,672,580,516,463,379,314,3485,125,189,143,98,95,54,71,775
島根県,3205,浜田,いいえ,805,1007,879,848,1027,1060,1458,7084,1011,1205,1118,1140,1229,1372,1931,9006
島根県,3206,益田,はい,434,499,355,351,333,298,255,2525,96,120,100,61,65,48,57,547
島根県,3206,益田,いいえ,608,744,608,655,767,868,1130,5380,697,876,769,811,923,1136,1530,6742
島根県,3207,隠岐,はい,173,203,129,113,122,108,93,941,31,62,44,31,19,16,17,220
島根県,3207,隠岐,いいえ,202,188,161,190,197,249,334,1521,252,269,224,240,266,338,459,2048
岡山県,3301,県南東部,はい,6329,7716,6529,5052,3847,2533,1998,34004,1380,1943,1641,1079,873,482,385,7783
岡山県,3301,県南東部,いいえ,11152,13925,12907,10924,9456,8144,9163,75671,12445,15205,14711,12571,10831,9897,12559,88219
岡山県,3302,県南西部,はい,5008,6185,5318,3953,2944,1893,1361,26662,940,1434,1113,694,484,278,198,5141
岡山県,3302,県南西部,いいえ,8224,10378,9740,7919,6980,6169,6982,56392,8846,11400,10914,8751,7728,7510,9308,64457
岡山県,3303,高梁・新見,はい,434,437,388,337,369,237,147,2349,93,86,74,56,55,31,16,411
岡山県,3303,高梁・新見,いいえ,390,598,589,642,736,712,760,4427,548,727,697,763,904,853,909,5401
岡山県,3304,真庭,はい,359,391,298,273,300,188,159,1968,76,82,64,51,42,29,17,361
岡山県,3304,真庭,いいえ,423,486,442,432,530,550,652,3515,528,609,592,662,705,758,866,4720
岡山県,3305,津山・英田,はい,1283,1497,1207,934,885,602,461,6869,357,443,353,238,197,97,80,1765
岡山県,3305,津山・英田,いいえ,1610,2001,1885,1603,1710,1690,2043,12542,2010,2420,2357,2147,2320,2240,2665,16159
広島県,3401,広島,はい,10197,12335,11241,8155,5689,3318,2415,53350,2001,2721,2540,1647,1153,573,414,11049
広島県,3401,広島,いいえ,17896,22923,22345,18285,14917,10972,11810,119148,19101,23902,23128,18334,14420,12153,14845,125883
広島県,3402,広島西,はい,897,1088,1008,739,648,437,340,5157,219,254,220,173,116,88,60,1130
広島県,3402,広島西,いいえ,1608,1964,1827,1720,1693,1636,1919,12367,1615,2091,2105,1837,1913,1939,2276,13776
広島県,3403,呉,はい,1194,1747,1553,1315,980,696,485,7970,257,426,394,250,173,81,81,1662
広島県,3403,呉,いいえ,1988,2928,2865,2622,2359,2036,2459,17257,2261,3161,3090,2842,2503,2316,3307,19480
広島県,3404,広島中央,はい,1604,1997,1734,1337,967,543,442,8624,274,440,330,232,165,78,41,1560
広島県,3404,広島中央,いいえ,2964,3561,3450,2873,2459,1868,2414,19589,2558,3310,3226,2704,2503,2199,3062,19562
広島県,3405,尾三,はい,1558,1851,1547,1263,1060,756,527,8562,296,437,377,281,198,112,68,1769
広島県,3405,尾三,いいえ,2320,3087,2862,2520,2553,2369,2818,18529,2439,3281,3161,2910,3060,2966,3571,21388
広島県,3406,福山・府中,はい,3667,4355,3756,2718,2145,1345,945,18931,711,1019,855,531,377,210,135,3838
広島県,3406,福山・府中,いいえ,6001,7437,6644,5531,4999,4291,4850,39753,6083,7455,7194,5917,5270,4984,5818,42721
広島県,3407,備北,はい,558,666,561,482,473,332,246,3318,132,184,142,90,81,52,32,713
広島県,3407,備北,いいえ,806,994,944,853,977,1033,1225,6832,960,1173,1128,1108,1239,1320,1459,8387
山口県,3501,岩国,はい,746,1000,879,700,570,394,287,4576,144,230,216,135,76,69,47,917
山口県,3501,岩国,いいえ,1169,1547,1573,1417,1359,1318,1606,9989,1275,1713,1849,1582,1487,1601,2082,11589
山口県,3502,柳井,はい,401,549,460,329,321,206,175,2441,73,119,101,60,57,39,34,483
山口県,3502,柳井,いいえ,702,935,875,744,772,818,875,5721,746,989,1081,879,963,981,1220,6859
山口県,3503,周南,はい,1653,2160,1854,1311,1021,622,582,9203,269,394,364,245,160,108,129,1669
山口県,3503,周南,いいえ,2668,3649,3541,2734,2457,2310,2959,20318,2806,3909,3730,3010,2829,2977,4399,23660
山口県,3504,山口・防府,はい,2381,2754,2361,1780,1502,892,725,12395,415,579,474,288,187,165,133,2241
山口県,3504,山口・防府,いいえ,3647,4668,4298,3791,3533,2916,3478,26331,3802,4601,4497,3867,3640,3476,4450,28333
山口県,3505,宇部・小野田,はい,1652,2034,1708,1370,1098,781,675,9318,349,468,381,256,188,122,132,1896
山口県,3505,宇部・小野田,いいえ,2682,3310,2975,2697,2560,2404,3024,19652,2734,3227,3408,2971,2803,3180,4305,22628
山口県,3506,下関,はい,1707,2148,1748,1340,1124,792,575,9434,344,518,486,371,267,161,118,2265
山口県,3506,下関,いいえ,2326,2965,2746,2486,2340,2225,2472,17560,2698,3332,3447,3126,2916,2836,3709,22064
山口県,3507,長門,はい,255,287,223,156,186,128,113,1348,36,54,31,43,30,22,12,228
山口県,3507,長門,いいえ,300,362,340,300,362,369,454,2487,376,436,464,431,549,577,685,3518
山口県,3508,萩,はい,300,420,313,279,212,212,151,1887,48,98,68,62,41,34,28,379
山口県,3508,萩,いいえ,376,477,501,469,583,575,661,3642,436,576,636,600,667,783,942,4640
徳島県,3601,東部,はい,3367,3774,3165,2536,2077,1416,1179,17514,750,1108,888,708,462,313,221,4450
徳島県,3601,東部,いいえ,5839,7051,6741,6035,5561,5197,6411,42835,6786,8258,7978,7185,6726,7303,8872,53108
徳島県,3603,南部,はい,952,1051,873,720,631,517,479,5223,189,275,234,201,125,80,70,1174
徳島県,3603,南部,いいえ,1526,1826,1694,1565,1571,1735,2421,12338,1583,1926,2027,1878,2057,2417,3310,15198
徳島県,3605,西部,はい,467,492,434,367,394,326,272,2752,116,148,135,117,97,49,36,698
徳島県,3605,西部,いいえ,623,727,711,824,897,1065,1255,6102,783,995,984,1104,1251,1375,1602,8094
香川県,3702,小豆,はい,177,201,194,173,148,124,105,1122,45,51,41,30,-,19,-,208
香川県,3702,小豆,いいえ,244,292,267,266,276,293,443,2081,304,364,363,369,396,457,657,2910
香川県,3706,東部,はい,3751,4614,3936,2962,2377,1614,1453,20707,791,1079,928,635,473,295,326,4527
香川県,3706,東部,いいえ,6528,8503,7911,6599,5819,5427,7352,48139,7345,9339,8902,7392,6976,7315,10755,58024
香川県,3707,西部,はい,2820,3504,2844,2277,1926,1398,1240,16009,615,794,704,410,-,210,-,3190
香川県,3707,西部,いいえ,4452,5334,4924,4345,4379,4392,5756,33582,4901,6208,5818,5299,5544,5941,8174,41885
愛媛県,3801,宇摩,はい,593,693,611,464,366,226,169,3122,115,148,123,71,39,20,22,538
愛媛県,3801,宇摩,いいえ,907,1171,1011,1040,878,786,892,6685,964,1231,1171,1073,934,991,1091,7455
愛媛県,3802,新居浜・西条,はい,1580,1953,1611,1316,981,604,489,8534,353,506,378,256,171,91,81,1836
愛媛県,3802,新居浜・西条,いいえ,2421,3057,2710,2512,2307,2009,2495,17511,2704,3355,3218,3000,2666,2627,3471,21041
愛媛県,3803,今治,はい,1040,1280,1169,825,664,368,305,5651,179,308,313,161,115,66,38,1180
愛媛県,3803,今治,いいえ,1586,2059,1878,1664,1560,1394,1679,11820,1773,2255,2275,2043,1836,1580,2100,13862
愛媛県,3804,松山,はい,4607,5476,4850,3734,2800,1769,1208,24444,1024,1369,1189,828,647,379,271,5707
愛媛県,3804,松山,いいえ,7941,9852,8980,7739,7243,5951,6094,53800,9094,10728,10396,8928,8114,7266,8342,62868
愛媛県,3805,八幡浜・大洲,はい,871,1067,852,772,698,430,346,5036,176,247,189,122,106,66,37,943
愛媛県,3805,八幡浜・大洲,いいえ,1178,1507,1453,1605,1651,1431,1555,10380,1569,1832,2061,1999,1982,1875,2064,13382
愛媛県,3806,宇和島,はい,649,787,674,604,567,391,281,3953,165,246,210,153,99,61,45,979
愛媛県,3806,宇和島,いいえ,973,1284,1169,1216,1198,1165,1565,8570,1220,1606,1630,1666,1748,1816,2194,11880
高知県,3901,安芸,はい,298,330,308,258,242,170,130,1736,83,113,90,72,65,41,22,486
高知県,3901,安芸,いいえ,337,407,434,455,448,498,705,3284,368,505,543,567,616,797,1107,4503
高知県,3902,中央,はい,3864,4513,3861,2928,2287,1528,1226,20207,1070,1456,1271,889,724,438,326,6174
高知県,3902,中央,いいえ,5415,7030,6118,5589,5238,4893,5999,40282,6840,8385,8014,7101,6580,6245,8064,51229
高知県,3903,高幡,はい,368,396,365,289,334,248,218,2218,89,140,105,95,85,61,48,623
高知県,3903,高幡,いいえ,442,505,524,528,573,695,932,4199,477,613,612,647,752,931,1154,5186
高知県,3904,幡多,はい,610,751,573,466,434,351,270,3455,167,242,180,145,116,76,66,992
高知県,3904,幡多,いいえ,695,884,806,753,844,960,1300,6242,899,1170,1107,1060,1183,1464,1884,8767
福岡県,4001,福岡・糸島,はい,13650,14947,12982,9485,6746,4112,2897,64819,3297,3902,3342,2476,1940,1143,744,16844
福岡県,4001,福岡・糸島,いいえ,20999,23968,22482,18597,15049,11748,12559,125402,25353,27628,25297,20041,15807,13533,15892,143551
福岡県,4002,粕屋,はい,2930,3278,2452,1750,1355,927,695,13387,636,791,670,462,368,211,150,3288
福岡県,4002,粕屋,いいえ,3532,4276,3544,2642,2631,2368,2652,21645,4301,4753,3818,3071,2880,2889,3397,25109
福岡県,4003,宗像,はい,1300,1198,922,736,682,455,356,5649,253,288,218,155,180,98,73,1265
福岡県,4003,宗像,いいえ,1862,2015,1783,1517,1628,1590,1848,12243,2236,2369,2153,1923,1858,1971,2275,14785
福岡県,4004,筑紫,はい,3334,3788,3232,2328,1851,1153,915,16601,723,854,779,564,438,268,203,3829
福岡県,4004,筑紫,いいえ,4846,5816,5403,4561,4094,3630,4085,32435,5823,6905,6394,5351,4480,4171,5142,38266
福岡県,4005,朝倉,はい,752,737,663,505,444,372,289,3762,169,211,171,133,112,74,31,901
福岡県,4005,朝倉,いいえ,769,896,756,733,811,889,1071,5925,944,1109,1059,1088,1087,1247,1455,7989
福岡県,4006,久留米,はい,3495,3826,3246,2742,2151,1495,1208,18163,856,1042,894,631,534,330,234,4521
福岡県,4006,久留米,いいえ,4334,5090,4763,4309,4315,4177,4924,31912,5482,6416,6418,5748,5265,5504,6782,41615
福岡県,4007,八女・筑後,はい,1057,1116,993,835,739,563,401,5704,244,288,251,203,168,95,66,1315
福岡県,4007,八女・筑後,いいえ,1230,1358,1264,1264,1380,1361,1760,9617,1515,1760,1808,1780,1773,1984,2427,13047
福岡県,4008,有明,はい,1432,1628,1378,1344,1107,770,572,8231,389,456,409,353,263,161,103,2134
福岡県,4008,有明,いいえ,1667,1861,2033,1914,2091,2041,2591,14198,2047,2461,2488,2583,2514,2869,3770,18732
福岡県,4009,飯塚,はい,1361,1439,1097,913,883,694,596,6983,387,499,386,286,290,191,137,2176
福岡県,4009,飯塚,いいえ,1407,1668,1451,1307,1524,1608,2260,11225,1984,2264,2028,1812,2103,2431,3290,15912
福岡県,4010,直方・鞍手,はい,903,865,697,571,552,408,385,4381,225,288,235,188,154,98,63,1251
福岡県,4010,直方・鞍手,いいえ,911,1039,887,787,941,963,1266,6794,1053,1099,1157,1032,1127,1325,1780,8573
福岡県,4011,田川,はい,856,905,744,574,554,465,395,4493,320,347,312,243,201,138,74,1635
福岡県,4011,田川,いいえ,758,966,883,803,897,984,1210,6501,1051,1288,1202,1161,1217,1457,1764,9140
福岡県,4012,北九州,はい,8223,9437,8001,6052,4877,3523,2959,43072,2005,2680,2273,1706,1329,825,782,11600
福岡県,4012,北九州,いいえ,10394,12646,12360,10952,10425,9520,11670,77967,12225,14629,15030,12921,11550,11868,16718,94941
福岡県,4013,京築,はい,1556,1873,1558,1240,1007,674,533,8441,409,536,411,298,220,153,98,2125
福岡県,4013,京築,いいえ,1738,2196,2098,1861,1867,1933,2391,14084,2039,2542,2489,2168,2253,2531,3221,17243
佐賀県,4101,中部,はい,2695,2895,2562,2231,1862,1311,898,14454,581,687,599,463,391,230,142,3093
佐賀県,4101,中部,いいえ,3461,3959,3757,3666,3512,3575,4080,26010,4326,5065,4897,4629,4397,4587,5111,33012
佐賀県,4102,東部,はい,1230,1259,1060,811,618,498,373,5849,193,282,216,153,109,76,70,1099
佐賀県,4102,東部,いいえ,1473,1666,1439,1289,1261,1218,1651,9997,1637,1882,1808,1392,1476,1655,2200,12050
佐賀県,4103,北部,はい,900,1051,755,717,666,494,311,4894,280,326,250,243,201,99,58,1457
佐賀県,4103,北部,いいえ,1030,1206,1070,1104,1160,1162,1474,8206,1334,1479,1362,1440,1548,1653,1801,10617
佐賀県,4104,西部,はい,686,646,542,485,467,340,268,3434,163,169,150,118,96,79,58,833
佐賀県,4104,西部,いいえ,728,800,796,775,815,909,1029,5852,949,993,960,1025,1084,1216,1516,7743
佐賀県,4105,南部,はい,1209,1183,1101,1070,965,725,575,6828,244,275,248,183,168,98,86,1302
佐賀県,4105,南部,いいえ,1159,1298,1296,1488,1541,1691,2123,10596,1601,1836,1875,1962,2199,2492,3010,14975
長崎県,4201,長崎,はい,3176,3993,3693,3069,2583,1851,1396,19761,726,894,897,781,650,452,290,4690
長崎県,4201,長崎,いいえ,4777,5905,6040,5683,5502,5213,6533,39653,6252,7613,7499,6946,6555,6860,8872,50597
長崎県,4202,佐世保県北,はい,1955,2248,1900,1706,1577,1150,894,11430,502,659,585,469,378,300,210,3103
長崎県,4202,佐世保県北,いいえ,2381,2836,2800,2854,2883,3049,3599,20402,3390,3909,3886,3602,3562,4002,4921,27272
長崎県,4203,県央,はい,2055,2227,2067,1653,1416,934,635,10987,423,499,439,385,283,200,140,2369
長崎県,4203,県央,いいえ,2639,3151,2980,2920,2884,2894,3228,20696,3525,3926,4004,3629,3480,3688,4530,26782
長崎県,4204,県南,はい,778,814,827,769,713,478,443,4822,146,168,168,116,101,74,52,825
長崎県,4204,県南,いいえ,848,1074,1075,1213,1436,1582,1933,9161,1297,1572,1732,1842,2077,2392,2835,13747
長崎県,4206,五島,はい,209,246,230,213,190,175,102,1365,52,58,49,53,46,35,23,316
長崎県,4206,五島,いいえ,240,305,297,337,395,447,526,2547,343,384,440,451,582,632,712,3544
長崎県,4207,上五島,はい,155,204,194,178,150,93,72,1046,-,25,26,42,30,26,-,181
長崎県,4207,上五島,いいえ,155,165,177,235,271,307,291,1601,172,245,245,288,333,352,419,2054
長崎県,4208,壱岐,はい,183,201,181,166,152,101,110,1094,-,78,66,62,35,23,-,321
長崎県,4208,壱岐,いいえ,213,244,255,230,282,346,429,1999,343,352,310,376,403,488,615,2887
長崎県,4209,対馬,はい,203,231,179,172,191,155,125,1256,67,56,58,63,43,25,17,329
長崎県,4209,対馬,いいえ,199,251,265,244,315,390,474,2138,276,336,324,344,448,578,661,2967
熊本県,4302,宇城,はい,838,841,755,741,622,463,307,4567,203,231,198,178,133,86,49,1078
熊本県,4302,宇城,いいえ,940,1094,1026,1163,1130,1167,1368,7888,1236,1366,1435,1411,1481,1568,1793,10290
熊本県,4303,有明,はい,1227,1166,1079,893,859,698,517,6439,281,357,280,215,209,119,76,1537
熊本県,4303,有明,いいえ,1430,1456,1362,1414,1494,1716,2090,10962,1752,2017,1949,2003,2142,2345,2792,15000
熊本県,4304,鹿本,はい,435,382,363,363,331,254,191,2319,128,145,109,72,74,39,27,594
熊本県,4304,鹿本,いいえ,416,484,494,456,565,611,807,3833,541,611,696,736,760,890,1084,5318
熊本県,4305,菊池,はい,1824,1793,1380,1159,944,611,393,8104,467,451,315,249,214,124,85,1905
熊本県,4305,菊池,いいえ,2381,2612,2124,2020,1903,1859,1918,14817,2956,3037,2629,2460,2326,2208,2311,17927
熊本県,4306,阿蘇,はい,496,460,428,435,423,361,252,2855,136,131,126,106,83,87,57,726
熊本県,4306,阿蘇,いいえ,492,581,544,616,739,1023,1205,5200,722,818,847,961,1105,1335,1514,7302
熊本県,4308,八代,はい,1111,1148,1029,904,732,448,282,5654,285,317,286,199,147,76,51,1361
熊本県,4308,八代,いいえ,1179,1378,1353,1415,1401,1404,1515,9645,1617,1949,1867,1962,2000,1965,2024,13384
熊本県,4309,芦北,はい,325,326,319,310,253,214,154,1901,85,103,81,54,50,29,18,420
熊本県,4309,芦北,いいえ,326,396,482,511,561,609,660,3545,449,505,610,663,708,844,884,4663
熊本県,4310,球磨,はい,783,813,664,709,608,470,327,4374,218,235,172,137,115,75,53,1005
熊本県,4310,球磨,いいえ,643,793,855,946,1196,1319,1623,7375,1112,1224,1305,1429,1581,1769,2154,10574
熊本県,4311,天草,はい,847,910,845,776,721,473,353,4925,220,297,223,227,155,88,44,1254
熊本県,4311,天草,いいえ,874,1042,1088,1159,1462,1610,1753,8988,1325,1547,1709,1926,2087,2273,2271,13138
熊本県,4312,熊本・上益城,はい,6350,6821,5623,4683,3578,2328,1502,30885,1553,2012,1433,1125,906,561,381,7971
熊本県,4312,熊本・上益城,いいえ,8555,10216,9315,9119,8660,7744,7942,61551,11361,13044,12309,11368,9838,9153,10431,77504
大分県,4401,東部,はい,1348,1551,1398,1177,1036,757,702,7969,394,447,430,379,288,215,196,2349
大分県,4401,東部,いいえ,1840,2241,2038,2027,2178,2250,2800,15374,2575,3119,3145,2970,2985,3009,4020,21823
大分県,4403,中部,はい,4803,5545,4540,3426,2775,1920,1393,24402,1028,1240,1045,717,602,342,261,5235
大分県,4403,中部,いいえ,6804,8326,7374,6698,6636,5975,6536,48349,8333,9812,9248,7983,7519,7177,8751,58823
大分県,4405,南部,はい,483,533,476,447,351,314,241,2845,104,152,134,68,66,50,37,611
大分県,4405,南部,いいえ,633,752,665,720,776,904,1126,5576,835,949,994,1050,1127,1313,1662,7930
大分県,4406,豊肥,はい,380,409,377,325,370,288,268,2417,93,121,94,68,98,49,57,580
大分県,4406,豊肥,いいえ,428,517,498,526,693,746,1080,4488,650,723,728,784,990,1122,1404,6401
大分県,4408,西部,はい,726,766,661,645,570,436,279,4083,184,183,169,139,121,66,46,908
大分県,4408,西部,いいえ,753,952,924,948,1089,1058,1243,6967,1089,1281,1262,1315,1372,1368,1634,9321
大分県,4409,北部,はい,1500,1703,1389,1135,904,619,450,7700,358,392,316,240,182,107,80,1675
大分県,4409,北部,いいえ,1684,1873,1850,1754,1786,1762,2059,12768,1907,2257,2290,2077,2275,2369,2846,16021
宮崎県,4501,宮崎東諸県,はい,3610,3841,3169,2411,1878,1257,817,16983,763,1002,732,535,413,247,165,3857
宮崎県,4501,宮崎東諸県,いいえ,4403,5624,5214,4884,4552,3905,4188,32770,5628,6784,6346,5609,4937,4720,5542,39566
宮崎県,4502,都城北諸県,はい,1647,1645,1291,1027,1006,708,615,7939,369,424,324,235,222,179,124,1877
宮崎県,4502,都城北諸県,いいえ,1634,1813,1628,1712,2078,2118,2801,13784,2104,2381,2357,2319,2618,3156,4096,19031
宮崎県,4503,延岡西臼杵,はい,1364,1546,1309,1084,928,601,506,7338,330,446,381,246,201,115,85,1804
宮崎県,4503,延岡西臼杵,いいえ,1472,1787,1772,1726,1698,1717,2255,12427,1594,1961,1921,1936,2005,2327,2971,14715
宮崎県,4504,日南串間,はい,488,491,448,392,363,278,212,2672,101,127,101,100,75,46,50,600
宮崎県,4504,日南串間,いいえ,423,465,505,559,721,778,917,4368,576,612,628,752,845,1021,1339,5773
宮崎県,4505,西諸,はい,536,462,376,385,374,330,236,2699,158,146,117,99,84,59,52,715
宮崎県,4505,西諸,いいえ,450,519,526,628,779,874,1260,5036,649,681,703,888,1016,1242,1580,6759
宮崎県,4506,西都児湯,はい,687,735,571,521,439,409,303,3665,183,252,182,135,115,84,67,1018
宮崎県,4506,西都児湯,いいえ,684,815,753,818,978,1202,1483,6733,969,1167,1111,1124,1282,1586,2037,9276
宮崎県,4507,日向入郷,はい,704,743,585,471,398,294,237,3432,171,241,192,120,87,62,53,926
宮崎県,4507,日向入郷,いいえ,642,779,694,786,820,944,1187,5852,960,1000,1059,955,1082,1218,1650,7924
鹿児島県,4601,鹿児島,はい,4941,5306,4360,3538,2947,2005,1454,24551,915,1047,851,589,459,329,231,4421
鹿児島県,4601,鹿児島,いいえ,6746,8055,7515,7358,7682,7329,8610,53295,8371,9447,9065,8296,8119,8859,11035,63192
鹿児島県,4603,南薩,はい,743,805,732,681,715,579,517,4772,167,188,155,107,77,73,54,821
鹿児島県,4603,南薩,いいえ,946,973,1044,1260,1525,1995,2443,10186,1127,1268,1359,1585,2022,2660,3292,13313
鹿児島県,4605,川薩,はい,909,965,820,783,742,570,455,5244,151,164,153,106,117,83,68,842
鹿児島県,4605,川薩,いいえ,1127,1300,1203,1497,1512,1679,2248,10566,1317,1453,1545,1663,1846,2253,2808,12885
鹿児島県,4606,出水,はい,622,596,554,504,416,308,223,3223,156,184,135,104,77,37,41,734
鹿児島県,4606,出水,いいえ,661,771,795,848,890,1028,1301,6294,874,976,1055,1102,1198,1494,1650,8349
鹿児島県,4607,姶良・伊佐,はい,1746,1888,1609,1504,1250,901,730,9628,393,392,308,231,251,181,119,1875
鹿児島県,4607,姶良・伊佐,いいえ,2245,2553,2644,2727,2933,2893,3884,19879,2722,3173,3288,3270,3405,3818,5029,24705
鹿児島県,4609,曽於,はい,528,511,472,456,477,379,269,3092,114,130,101,80,95,52,43,615
鹿児島県,4609,曽於,いいえ,525,544,610,705,928,952,1167,5431,686,703,791,972,1161,1267,1469,7049
鹿児島県,4610,肝属,はい,1156,1050,905,823,833,602,398,5767,208,263,253,163,144,93,61,1185
鹿児島県,4610,肝属,いいえ,1179,1277,1257,1471,1732,1835,2198,10949,1472,1614,1656,1810,2076,2359,2794,13781
鹿児島県,4611,熊毛,はい,299,332,326,301,263,197,133,1851,77,82,66,49,47,28,31,380
鹿児島県,4611,熊毛,いいえ,274,354,389,389,420,498,579,2903,355,385,439,420,493,667,769,3528
鹿児島県,4612,奄美,はい,608,700,624,554,525,402,281,3694,212,251,185,164,139,97,64,1112
鹿児島県,4612,奄美,いいえ,807,882,899,1022,1101,1398,1479,7588,1043,1077,1082,1097,1398,1803,1927,9427
沖縄県,4701,北部,はい,658,630,506,449,431,414,297,3385,196,231,159,156,135,85,48,1010
沖縄県,4701,北部,いいえ,946,1123,897,905,1094,1194,1269,7428,1145,1177,992,1121,1274,1352,1389,8450
沖縄県,4702,中部,はい,3046,3341,2660,1963,1424,1042,612,14088,910,1035,862,680,441,240,126,4294
沖縄県,4702,中部,いいえ,5046,6365,5738,5008,4299,3664,3600,33720,6341,7628,6825,5589,4832,4445,4436,40096
沖縄県,4703,南部,はい,4671,5118,4420,3234,2429,1721,1158,22751,1333,1511,1273,1008,749,439,211,6524
沖縄県,4703,南部,いいえ,8415,10057,9298,8124,7234,6597,6873,56598,10792,12109,11440,9649,8465,8444,8659,69558
沖縄県,4704,宮古,はい,362,345,302,258,226,197,141,1831,112,117,81,58,40,33,15,456
沖縄県,4704,宮古,いいえ,436,548,482,585,694,756,682,4183,644,637,574,696,847,914,868,5180
沖縄県,4705,八重山,はい,423,434,361,259,288,255,156,2176,233,209,178,142,132,81,32,1007
沖縄県,4705,八重山,いいえ,563,628,649,571,646,664,716,4437,702,799,640,597,694,858,807,5097
二次医療圏判別不可,,,はい,27354,29873,28889,25028,11549,2566,945,126204,3989,5448,5259,3840,2400,792,234,21962
二次医療圏判別不可,,,いいえ,61870,67495,66785,62590,31788,8974,5836,305338,41769,48249,46190,36054,18444,7412,4604,202722
