都道府県名,二次医療圏番号,二次医療圏名,回答,男40～44歳,男45～49歳,男50～54歳,男55～59歳,男60～64歳,男65～69歳,男70～74歳,男中計,女40～44歳,女45～49歳,女50～54歳,女55～59歳,女60～64歳,女65～69歳,女70～74歳,女中計
北海道,0101,南渡島,はい,1787,2055,1761,1268,878,578,407,8734,943,1238,1160,861,564,424,321,5511
北海道,0101,南渡島,いいえ,2713,3688,3407,3403,3362,3192,3738,23503,2562,3358,3455,3296,3313,3605,4842,24431
北海道,0102,南檜山,はい,113,110,114,80,51,52,28,548,57,66,64,57,41,23,28,336
北海道,0102,南檜山,いいえ,159,240,217,225,253,213,250,1557,150,172,183,186,217,245,337,1490
北海道,0103,北渡島檜山,はい,157,179,143,108,70,50,30,737,79,88,68,51,41,24,21,372
北海道,0103,北渡島檜山,いいえ,240,269,287,283,288,298,329,1994,168,236,222,264,261,329,402,1882
北海道,0104,札幌,はい,14612,16224,13583,9469,6072,2717,1253,63930,7241,8411,7424,5266,3077,1240,637,33296
北海道,0104,札幌,いいえ,22804,28514,28757,27170,25254,16228,9930,158657,22160,26718,26012,22690,17179,10097,7419,132275
北海道,0105,後志,はい,1007,1200,973,711,516,331,248,4986,486,629,508,445,316,202,203,2789
北海道,0105,後志,いいえ,1514,2074,2113,2128,1977,1911,2057,13774,1289,1803,1845,1758,1731,1858,2512,12796
北海道,0106,南空知,はい,639,838,636,537,391,211,142,3394,330,445,401,348,241,162,125,2052
北海道,0106,南空知,いいえ,1126,1618,1540,1659,1780,1678,1603,11004,1001,1406,1480,1461,1492,1432,1852,10124
北海道,0107,中空知,はい,419,551,420,364,262,150,125,2291,262,329,305,247,157,137,112,1549
北海道,0107,中空知,いいえ,635,977,1000,1049,1057,1004,1233,6955,669,883,857,953,954,1097,1544,6957
北海道,0108,北空知,はい,110,134,107,85,59,46,30,571,65,68,63,53,44,22,20,335
北海道,0108,北空知,いいえ,166,246,245,315,345,328,414,2059,205,234,274,278,288,365,493,2137
北海道,0109,西胆振,はい,792,1008,803,609,388,258,220,4078,414,571,486,392,300,179,140,2482
北海道,0109,西胆振,いいえ,1382,1986,1871,1697,1706,1708,2193,12543,1175,1545,1621,1506,1460,1797,2682,11786
北海道,0110,東胆振,はい,1390,1633,1198,917,575,349,257,6319,604,753,636,480,298,223,169,3163
北海道,0110,東胆振,いいえ,2359,3020,2668,2475,2290,2302,2617,17731,1719,2087,1919,1874,1789,2249,3066,14703
北海道,0111,日高,はい,271,318,221,161,104,63,45,1183,131,161,177,127,65,41,37,739
北海道,0111,日高,いいえ,453,588,572,524,524,478,501,3640,368,479,429,433,453,499,601,3262
北海道,0112,上川中部,はい,1686,1968,1559,1121,727,347,160,7568,844,976,916,608,379,161,83,3967
北海道,0112,上川中部,いいえ,2637,3361,3253,3169,3195,2168,1502,19285,2356,2964,2939,2523,2053,1365,1292,15492
北海道,0113,上川北部,はい,244,255,220,153,113,59,38,1082,100,120,107,78,43,36,28,512
北海道,0113,上川北部,いいえ,388,576,551,606,588,459,471,3639,364,433,399,417,461,437,554,3065
北海道,0114,富良野,はい,183,207,180,130,98,58,47,903,96,117,111,70,57,27,43,521
北海道,0114,富良野,いいえ,341,426,431,526,510,497,595,3326,367,453,468,464,476,542,753,3523
北海道,0115,留萌,はい,175,244,213,151,103,75,39,1000,81,125,120,99,65,54,50,594
北海道,0115,留萌,いいえ,308,427,436,432,451,407,427,2888,275,358,363,355,402,432,591,2776
北海道,0116,宗谷,はい,363,431,334,284,186,126,76,1800,174,181,196,129,82,70,36,868
北海道,0116,宗谷,いいえ,519,708,651,654,662,603,535,4332,457,510,456,484,479,459,573,3418
北海道,0117,北網,はい,1108,1203,924,706,527,248,161,4877,513,634,528,453,310,181,160,2779
北海道,0117,北網,いいえ,1674,2316,2180,2197,2198,1743,1961,14269,1528,1923,1840,1916,1844,1837,2446,13334
北海道,0118,遠紋,はい,284,331,283,206,149,80,54,1387,130,169,136,124,66,65,59,749
北海道,0118,遠紋,いいえ,472,642,665,713,663,579,720,4454,362,448,545,540,555,643,926,4019
北海道,0119,十勝,はい,1710,1973,1564,1187,778,416,304,7932,873,1075,914,708,448,323,249,4590
北海道,0119,十勝,いいえ,2831,3630,3521,3592,3650,3280,3532,24036,2551,3266,3301,3209,3088,3260,4171,22846
北海道,0120,釧路,はい,1350,1551,1238,893,630,383,281,6326,738,874,758,581,401,256,178,3786
北海道,0120,釧路,いいえ,1774,2377,2411,2376,2486,2214,2425,16063,1538,2069,2057,1959,2016,2321,2792,14752
北海道,0121,根室,はい,372,425,295,223,153,95,56,1619,178,232,175,155,91,55,44,930
北海道,0121,根室,いいえ,578,684,648,681,639,543,546,4319,537,547,581,538,563,579,595,3940
青森県,0201,津軽地域,はい,1184,1253,982,709,455,188,117,4888,632,661,606,452,261,111,73,2796
青森県,0201,津軽地域,いいえ,2653,2993,2979,3078,2968,2210,1992,18873,2450,2921,2902,3129,2607,2160,2182,18351
青森県,0202,八戸地域,はい,1940,2136,1848,1302,946,467,286,8925,971,1046,1073,712,526,266,175,4769
青森県,0202,八戸地域,いいえ,3934,4950,5213,4970,4948,4217,4137,32369,3387,4515,4591,4360,4177,4181,4662,29873
青森県,0203,青森地域,はい,1877,2118,1672,1345,906,453,340,8711,1020,1149,971,724,511,278,270,4923
青森県,0203,青森地域,いいえ,3483,4435,4420,4453,4503,3681,4181,29156,3395,4246,4020,4108,3930,4042,5341,29082
青森県,0204,西北五地域,はい,436,451,410,356,205,150,102,2110,263,287,271,198,170,90,93,1372
青森県,0204,西北五地域,いいえ,831,1142,1179,1314,1237,1366,1555,8624,836,1068,1256,1394,1554,1868,2084,10060
青森県,0205,上十三地域,はい,975,1047,800,572,424,226,169,4213,477,558,470,349,249,164,120,2387
青森県,0205,上十三地域,いいえ,1999,2357,2363,2292,2356,2154,2233,15754,1691,2116,2116,2043,2156,2298,2638,15058
青森県,0206,下北地域,はい,342,341,264,224,159,100,70,1500,177,252,194,129,91,53,45,941
青森県,0206,下北地域,いいえ,571,771,770,809,875,821,840,5457,565,709,768,725,822,907,970,5466
岩手県,0301,盛岡,はい,3232,3272,2605,1764,1182,618,432,13105,1483,1668,1453,963,667,406,323,6963
岩手県,0301,盛岡,いいえ,6352,7831,7720,7438,7440,6412,7150,50343,5925,7205,6893,6592,6604,7116,8781,49116
岩手県,0302,岩手中部,はい,1440,1496,1066,833,525,269,162,5791,602,703,528,368,234,174,128,2737
岩手県,0302,岩手中部,いいえ,3187,3665,3444,3456,3290,3235,3476,23753,2586,3129,3042,2998,3032,3452,4179,22418
岩手県,0303,胆江,はい,747,829,550,433,280,157,110,3106,333,370,285,204,160,78,70,1500
岩手県,0303,胆江,いいえ,1903,2222,1991,2040,2227,2268,2383,15034,1606,1857,1710,1815,2015,2380,2910,14293
岩手県,0304,両磐,はい,637,647,426,325,237,142,81,2495,255,286,203,174,100,85,64,1167
岩手県,0304,両磐,いいえ,1510,1757,1727,1852,1955,1940,2105,12846,1313,1557,1567,1651,1820,2011,2180,12099
岩手県,0305,気仙,はい,242,326,265,197,136,81,50,1297,130,150,138,111,73,40,30,672
岩手県,0305,気仙,いいえ,581,793,878,949,849,851,973,5874,544,725,788,868,836,1037,1225,6023
岩手県,0306,釜石,はい,206,242,198,143,102,56,39,986,114,113,97,89,61,38,22,534
岩手県,0306,釜石,いいえ,425,534,585,607,543,579,595,3868,352,451,474,483,525,574,803,3662
岩手県,0307,宮古,はい,318,358,315,267,142,97,66,1563,157,168,178,119,86,55,51,814
岩手県,0307,宮古,いいえ,785,881,1114,1100,1041,1086,1395,7402,637,837,895,864,1033,1247,1638,7151
岩手県,0308,久慈,はい,255,262,212,169,155,66,54,1173,142,158,134,98,58,50,50,690
岩手県,0308,久慈,いいえ,582,748,829,747,900,859,1013,5678,522,648,781,706,884,1002,1167,5710
岩手県,0309,二戸,はい,258,269,245,191,126,95,52,1236,132,136,158,103,76,45,44,694
岩手県,0309,二戸,いいえ,558,697,756,855,910,1012,1076,5864,562,654,794,780,906,1109,1275,6080
宮城県,0401,仙南,はい,931,990,789,556,397,262,170,4095,403,485,385,273,240,155,122,2063
宮城県,0401,仙南,いいえ,2085,2334,2166,2206,2441,2863,3276,17371,1815,2192,2080,2232,2435,3038,3348,17140
宮城県,0403,仙台,はい,10630,11512,9281,5803,3650,2044,1472,44392,5144,5688,4668,3116,2039,1329,1151,23135
宮城県,0403,仙台,いいえ,20985,25793,24957,22190,20091,18646,21633,154295,20658,24704,23118,20131,19169,20366,26078,154224
宮城県,0406,大崎・栗原,はい,1493,1444,1047,837,594,379,232,6026,616,745,521,372,311,207,174,2946
宮城県,0406,大崎・栗原,いいえ,3564,3887,3497,3761,4260,4420,4637,28026,3172,3531,3435,3574,4009,4607,4780,27108
宮城県,0409,石巻・登米・気仙沼,はい,1728,1756,1473,1032,770,477,312,7548,787,897,792,540,393,255,244,3908
宮城県,0409,石巻・登米・気仙沼,いいえ,3675,4339,4181,4369,4703,5220,6260,32747,3323,3917,3974,4474,4966,5830,7046,33530
秋田県,0501,大館・鹿角,はい,377,377,345,279,186,126,82,1772,193,197,167,137,109,65,77,945
秋田県,0501,大館・鹿角,いいえ,812,1015,956,1078,1188,1158,1415,7622,823,910,955,998,1140,1352,1781,7959
秋田県,0502,北秋田,はい,93,94,70,66,43,35,32,433,41,48,40,28,21,14,20,212
秋田県,0502,北秋田,いいえ,200,285,280,354,334,426,490,2369,173,222,235,265,335,462,585,2277
秋田県,0503,能代・山本,はい,310,285,271,207,152,96,65,1386,165,201,193,144,86,76,41,906
秋田県,0503,能代・山本,いいえ,643,856,855,917,1023,1031,1135,6460,642,758,893,919,1082,1190,1489,6973
秋田県,0504,秋田周辺,はい,1663,1771,1370,975,659,372,280,7090,840,853,774,525,361,264,240,3857
秋田県,0504,秋田周辺,いいえ,3434,4491,4463,4568,4432,4075,4838,30301,3316,4034,4056,3834,4129,4914,6434,30717
秋田県,0505,由利本荘・にかほ,はい,417,425,332,250,184,138,78,1824,201,203,187,142,122,70,41,966
秋田県,0505,由利本荘・にかほ,いいえ,908,981,1032,1126,1201,1352,1495,8095,879,1027,1083,1126,1238,1598,1664,8615
秋田県,0506,大仙・仙北,はい,399,360,294,192,153,123,72,1593,211,185,154,100,97,79,63,889
秋田県,0506,大仙・仙北,いいえ,945,1136,1134,1240,1447,1618,2034,9554,926,1047,1095,1217,1563,2165,2414,10427
秋田県,0507,横手,はい,332,344,249,200,126,75,75,1401,173,202,167,122,82,63,54,863
秋田県,0507,横手,いいえ,970,1051,1027,1113,1245,1319,1507,8232,943,1093,1126,1162,1322,1667,1721,9034
秋田県,0508,湯沢・雄勝,はい,204,200,165,121,89,60,37,876,93,96,83,56,57,40,29,454
秋田県,0508,湯沢・雄勝,いいえ,548,604,686,786,892,1019,1119,5654,449,580,677,706,857,1097,1219,5585
山形県,0601,村山,はい,3415,3416,2742,1876,1321,738,460,13968,1563,1707,1427,998,812,413,279,7199
山形県,0601,村山,いいえ,8181,8981,8502,8563,8891,8782,9427,61327,8174,8979,8428,8467,8712,8994,9227,60981
山形県,0602,最上,はい,387,399,293,234,183,91,45,1632,177,220,188,123,112,61,30,911
山形県,0602,最上,いいえ,1000,1149,1080,1263,1472,1518,1563,9045,972,1110,1176,1281,1523,1609,1522,9193
山形県,0603,置賜,はい,1314,1323,1067,766,572,303,202,5547,572,624,584,399,281,161,113,2734
山形県,0603,置賜,いいえ,3166,3642,3564,3630,3752,3787,3980,25521,3054,3467,3391,3535,3627,3842,3899,24815
山形県,0604,庄内,はい,1638,1741,1425,1070,829,448,276,7427,864,956,808,617,441,255,215,4156
山形県,0604,庄内,いいえ,3989,4556,4461,4567,4956,5102,5516,33147,3952,4561,4583,4727,5116,5615,6178,34732
福島県,0701,県北,はい,2944,3259,2720,2000,1380,761,514,13578,1477,1718,1587,1144,797,472,398,7593
福島県,0701,県北,いいえ,5983,7233,7052,7107,7299,7091,8210,49975,5723,6815,6798,6665,6990,7636,8913,49540
福島県,0702,県中,はい,3294,3407,2657,1821,1297,726,418,13620,1566,1709,1408,1085,752,437,333,7290
福島県,0702,県中,いいえ,6146,7247,6716,6769,6991,6430,6968,47267,6016,6921,6579,6647,6846,6986,8040,48035
福島県,0703,県南,はい,989,979,740,589,376,254,155,4082,467,451,364,264,236,135,105,2022
福島県,0703,県南,いいえ,1940,2168,1976,2178,2267,2319,2464,15312,1746,2029,1820,1880,2288,2462,2638,14863
福島県,0706,相双,はい,631,643,504,406,308,224,195,2911,343,369,308,226,207,123,133,1709
福島県,0706,相双,いいえ,1497,1826,1648,1728,2085,2534,3058,14376,1284,1528,1576,1729,2314,2885,3416,14732
福島県,0707,いわき,はい,1766,1958,1599,1086,733,407,272,7821,895,1019,875,647,510,277,192,4415
福島県,0707,いわき,いいえ,3867,4761,4690,4486,4228,3762,3852,29646,3336,4084,3994,3909,3862,3592,4181,26958
福島県,0708,会津・南会津,はい,1465,1491,1189,935,716,495,306,6597,730,792,715,541,440,263,209,3690
福島県,0708,会津・南会津,いいえ,2972,3468,3369,3843,4122,4146,4661,26581,2824,3366,3428,3787,4105,4711,5194,27415
茨城県,0801,水戸,はい,2791,3130,2578,1689,932,448,247,11815,1265,1502,1326,893,555,279,176,5996
茨城県,0801,水戸,いいえ,5472,6822,6772,6066,5376,4024,3517,38049,4829,5853,5804,5214,4350,3814,3763,33627
茨城県,0802,日立,はい,1077,1199,1050,714,458,256,166,4920,549,672,651,394,266,169,125,2826
茨城県,0802,日立,いいえ,2456,3249,3406,3179,2908,2555,2943,20696,2239,3130,3438,2965,2686,2768,3498,20724
茨城県,0803,常陸太田・ひたちなか,はい,1875,2085,1782,1289,708,328,197,8264,779,925,884,570,355,240,174,3927
茨城県,0803,常陸太田・ひたちなか,いいえ,4407,5589,6000,5468,4771,4366,4782,35383,3668,4580,4934,4352,4254,4569,5261,31618
茨城県,0804,鹿行,はい,1633,1795,1406,869,573,293,179,6748,757,843,734,481,325,162,119,3421
茨城県,0804,鹿行,いいえ,3033,3839,3609,3159,2732,2428,2218,21018,2417,2903,2932,2556,2443,2310,2500,18061
茨城県,0805,土浦,はい,1614,1806,1500,1010,588,338,172,7028,710,874,758,480,330,194,140,3486
茨城県,0805,土浦,いいえ,2984,3823,3838,3464,2954,2896,3100,23059,2397,3230,3224,2921,2803,2864,3555,20994
茨城県,0806,つくば,はい,2355,2303,1804,1075,655,313,213,8718,976,1173,920,602,364,220,153,4408
茨城県,0806,つくば,いいえ,5238,5848,5225,4424,3640,3137,3597,31109,4617,5177,4541,3695,3223,3338,3897,28488
茨城県,0807,取手・竜ヶ崎,はい,2839,3310,2666,1667,992,579,424,12477,1231,1497,1322,848,583,358,292,6131
茨城県,0807,取手・竜ヶ崎,いいえ,5360,7069,6963,6160,5329,5152,6423,42456,4855,6138,5937,5301,4944,5477,6953,39605
茨城県,0808,筑西・下妻,はい,1432,1559,1226,828,513,320,179,6057,606,765,673,479,298,193,131,3145
茨城県,0808,筑西・下妻,いいえ,2903,3583,3421,3140,3169,3162,2994,22372,2522,3115,3176,2949,3030,3354,3311,21457
茨城県,0809,古河・坂東,はい,1367,1474,1203,793,527,255,118,5737,568,655,595,363,258,145,75,2659
茨城県,0809,古河・坂東,いいえ,2445,2935,3114,2672,2493,1833,1539,17031,1929,2564,2579,2187,2073,1767,1622,14721
栃木県,0901,県北,はい,2470,2519,1996,1338,884,536,361,10104,1035,1188,1012,657,485,332,239,4948
栃木県,0901,県北,いいえ,5217,6004,5707,5248,5450,5682,6221,39529,4274,5090,4965,4715,5133,5837,6504,36518
栃木県,0902,県西,はい,953,1135,956,633,475,277,186,4615,450,563,442,349,232,150,112,2298
栃木県,0902,県西,いいえ,2037,2680,2753,2555,2568,2482,2742,17817,1759,2284,2411,2240,2324,2583,3098,16699
栃木県,0903,宇都宮,はい,3863,4158,3398,2110,1209,594,374,15706,1622,1828,1646,1071,557,356,278,7358
栃木県,0903,宇都宮,いいえ,8407,9772,9523,8213,6625,4879,5144,52563,6796,8008,7509,6161,5248,4822,5857,44401
栃木県,0904,県東,はい,981,1059,742,536,350,247,149,4064,413,475,347,262,192,125,83,1897
栃木県,0904,県東,いいえ,2253,2552,2346,2230,2303,2473,2648,16805,1679,2018,1955,1840,2180,2589,2805,15066
栃木県,0905,県南,はい,2947,3380,2614,1731,1073,582,382,12709,1239,1420,1377,900,600,363,264,6163
栃木県,0905,県南,いいえ,6118,8051,7525,6754,6494,6212,6603,47757,5370,6549,6566,5618,5774,6254,7110,43241
栃木県,0906,両毛,はい,1556,1715,1496,1016,631,344,267,7025,641,773,723,538,368,268,236,3547
栃木県,0906,両毛,いいえ,3000,3888,3912,3548,3157,2905,3324,23734,2297,3063,3123,2849,2721,3059,3887,20999
群馬県,1001,前橋,はい,2036,2258,1898,1215,850,443,344,9044,936,1091,1080,763,492,307,296,4965
群馬県,1001,前橋,いいえ,4583,5659,5598,5037,4554,4344,4908,34683,3706,4908,4868,4552,4164,4685,6031,32914
群馬県,1002,渋川,はい,663,660,516,335,277,143,88,2682,264,314,274,196,134,101,88,1371
群馬県,1002,渋川,いいえ,1337,1640,1615,1510,1660,1556,1730,11048,1176,1404,1511,1306,1389,1570,1954,10310
群馬県,1003,伊勢崎,はい,1675,2037,1630,1014,614,304,206,7480,735,879,820,571,334,204,199,3742
群馬県,1003,伊勢崎,いいえ,3268,3998,4080,3756,3371,2970,3511,24954,2803,3547,3634,3039,2824,3234,4395,23476
群馬県,1004,高崎・安中,はい,2529,2947,2524,1609,906,486,329,11330,1019,1343,1265,861,540,305,323,5656
群馬県,1004,高崎・安中,いいえ,5449,7098,7296,6364,5486,4915,5723,42331,4657,6180,6278,5472,4743,5347,7162,39839
群馬県,1005,藤岡,はい,350,427,339,236,148,83,57,1640,146,193,214,133,89,63,54,892
群馬県,1005,藤岡,いいえ,722,1033,1003,936,889,855,1134,6572,552,830,858,807,807,930,1321,6105
群馬県,1006,富岡,はい,256,336,260,212,145,86,52,1347,102,162,139,104,73,44,50,674
群馬県,1006,富岡,いいえ,806,1016,1019,1048,1072,1173,1347,7481,687,942,984,967,1028,1264,1540,7412
群馬県,1007,吾妻,はい,218,258,250,162,155,85,77,1205,76,107,103,98,73,60,48,565
群馬県,1007,吾妻,いいえ,467,687,726,774,874,940,1099,5567,450,613,706,713,801,871,1163,5317
群馬県,1008,沼田,はい,375,439,337,275,195,108,90,1819,201,258,192,168,142,82,67,1110
群馬県,1008,沼田,いいえ,742,988,1131,1138,1232,1401,1557,8189,701,982,1012,1098,1225,1451,1709,8178
群馬県,1009,桐生,はい,843,1020,862,568,383,216,186,4078,373,529,522,359,236,145,150,2314
群馬県,1009,桐生,いいえ,1693,2288,2482,2195,2052,1898,2668,15276,1419,1985,2167,1853,1870,2247,3300,14841
群馬県,1010,太田・館林,はい,2786,3014,2395,1497,818,469,406,11385,993,1288,1145,643,459,319,288,5135
群馬県,1010,太田・館林,いいえ,5547,6642,6561,5568,4452,4362,5872,39004,3875,5193,5012,4215,3947,4951,7110,34303
埼玉県,1101,南部,はい,6252,6572,5670,3528,1995,975,754,25746,2631,3036,2752,1900,1053,556,600,12528
埼玉県,1101,南部,いいえ,10386,12911,13271,10965,8128,6439,7484,69584,8890,10997,11004,8924,6943,6179,9144,62081
埼玉県,1102,南西部,はい,5285,5661,4934,3174,1640,950,719,22363,2257,2583,2620,1749,949,557,636,11351
埼玉県,1102,南西部,いいえ,9804,12146,12411,10494,7809,6455,8468,67587,8993,11070,10980,8944,6724,6839,10743,64293
埼玉県,1103,東部,はい,7729,9045,7785,4672,2754,1486,1299,34770,3531,4264,4096,2769,1614,1066,1086,18426
埼玉県,1103,東部,いいえ,13156,17406,17466,14253,11047,10300,14338,97966,12278,15748,15719,12422,10404,11918,19244,97733
埼玉県,1104,さいたま,はい,9357,10136,8681,5385,2994,1357,885,38795,3726,4148,3993,2649,1493,799,689,17497
埼玉県,1104,さいたま,いいえ,18107,22073,22784,19739,15882,12018,14078,124681,16089,19281,19584,16275,12712,11615,16197,111753
埼玉県,1105,県央,はい,3354,3864,3350,2084,1214,701,557,15124,1347,1696,1755,1042,680,489,465,7474
埼玉県,1105,県央,いいえ,6611,8794,9121,7772,6638,6106,8042,53084,5431,7318,7633,6453,5595,6456,10197,49083
埼玉県,1106,川越比企,はい,5027,5753,4782,2952,1734,1012,849,22109,1970,2391,2257,1528,966,647,633,10392
埼玉県,1106,川越比企,いいえ,9982,12850,12965,10956,9732,8930,11487,76902,8099,10398,10481,8859,8410,9347,13264,68858
埼玉県,1107,西部,はい,4535,5472,4743,3062,1768,1025,765,21370,2067,2584,2388,1623,1029,616,527,10834
埼玉県,1107,西部,いいえ,8795,11749,12332,10837,9480,8292,10347,71832,7954,10074,10390,9095,7913,8299,11663,65388
埼玉県,1108,利根,はい,3594,4296,3483,2202,1400,772,624,16371,1418,1767,1666,1077,731,458,443,7560
埼玉県,1108,利根,いいえ,7061,9355,9276,8035,7786,7780,9423,58716,5935,7560,7532,6897,6825,8118,11386,54253
埼玉県,1109,北部,はい,2972,3315,2697,1764,1160,600,373,12881,1318,1537,1354,1024,621,355,319,6528
埼玉県,1109,北部,いいえ,6212,7584,7756,6931,6324,6002,6436,47245,5124,6613,6713,6017,5781,5898,6928,43074
埼玉県,1110,秩父,はい,396,417,379,287,193,125,86,1883,162,248,224,158,123,80,66,1061
埼玉県,1110,秩父,いいえ,890,1142,1319,1258,1349,1392,1511,8861,767,1037,1114,1115,1193,1406,1581,8213
千葉県,1201,千葉,はい,6385,7552,6686,4197,2273,1077,848,29018,2792,3369,3191,2039,1228,678,712,14009
千葉県,1201,千葉,いいえ,11728,15825,17373,14268,11155,8253,10251,88853,10232,13519,14547,11555,8910,8456,12894,80113
千葉県,1202,東葛南部,はい,12971,14464,12617,7858,3949,1912,1299,55070,5629,6468,5994,3891,2168,1086,865,26101
千葉県,1202,東葛南部,いいえ,22783,28834,30357,24896,17909,12207,13377,150363,21160,26233,26525,20446,14546,11940,15887,136737
千葉県,1203,東葛北部,はい,9765,10813,9126,5461,3201,1630,1229,41225,4227,4842,4432,2920,1697,1026,1039,20183
千葉県,1203,東葛北部,いいえ,17629,21818,22072,18450,14736,12604,15975,123284,16154,19629,19393,15976,13072,13783,20050,118057
千葉県,1204,印旛,はい,4315,4706,4092,2456,1650,939,658,18816,1917,2262,2021,1334,924,598,453,9509
千葉県,1204,印旛,いいえ,7866,9880,9748,8505,8092,8301,9695,62087,7343,9039,8826,7689,7675,8464,10221,59257
千葉県,1205,香取海匝,はい,1153,1369,1188,819,609,411,301,5850,544,630,636,491,337,269,202,3109
千葉県,1205,香取海匝,いいえ,2235,2875,3080,3014,3298,3573,4445,22520,1928,2429,2791,2859,3510,4239,5259,23015
千葉県,1206,山武長生夷隅,はい,1991,2336,2015,1327,1024,617,466,9776,941,1101,1096,843,589,387,288,5245
千葉県,1206,山武長生夷隅,いいえ,3860,5087,5307,5203,5332,5766,6882,37437,3338,4312,4739,4653,5107,5817,7042,35008
千葉県,1207,安房,はい,451,559,531,319,226,132,92,2310,248,332,313,204,121,98,74,1390
千葉県,1207,安房,いいえ,873,1150,1256,1168,1257,1247,1449,8400,898,1189,1204,1074,1178,1355,1750,8648
千葉県,1208,君津,はい,1829,2138,1737,1103,770,528,399,8504,830,1004,1020,610,436,294,303,4497
千葉県,1208,君津,いいえ,3921,4900,4770,4164,4062,4393,5429,31639,2981,3681,3656,3357,3298,4447,6255,27675
千葉県,1209,市原,はい,1382,1710,1373,830,585,386,268,6534,666,786,749,528,330,237,220,3516
千葉県,1209,市原,いいえ,2624,3511,3633,3145,2937,3465,4063,23378,2329,3075,3114,2705,2879,3608,4659,22369
東京都,1301,区中央部,はい,13648,13532,11139,7149,3688,1506,1108,51770,7237,7230,5973,3708,1998,939,945,28030
東京都,1301,区中央部,いいえ,23461,27280,27409,23890,16360,8334,7378,134112,19811,21892,20513,15359,10416,7142,9028,104161
東京都,1302,区南部,はい,10745,10938,9331,5814,3282,1627,1392,43129,5805,6105,5328,3383,1892,1099,1111,24723
東京都,1302,区南部,いいえ,17503,20915,22191,18194,12938,8784,10453,110978,17277,19859,18759,14271,10501,9413,13341,103421
東京都,1303,区西南部,はい,11197,10299,8374,5700,3099,1565,1237,41471,7796,7493,6292,4120,2387,1316,1275,30679
東京都,1303,区西南部,いいえ,17656,20436,20265,18631,13939,9664,11235,111826,20635,23759,22716,18463,13874,11489,15753,126689
東京都,1304,区西部,はい,11129,10210,8082,5467,2914,1640,1299,40741,6684,6576,5394,3653,2181,1236,1221,26945
東京都,1304,区西部,いいえ,17141,19316,19211,16855,12979,9376,10730,105608,18465,20687,20191,16791,12972,10648,14405,114159
東京都,1305,区西北部,はい,15508,15257,12753,8538,5084,2881,2358,62379,8209,8800,7922,5651,3582,2297,1982,38443
東京都,1305,区西北部,いいえ,25317,29074,29342,25730,21213,16417,19449,166542,25620,29713,29890,25374,21150,19236,26392,177375
東京都,1306,区東北部,はい,9593,10574,9019,5991,3637,2246,2082,43142,4901,5728,5608,3907,2469,1593,1690,25896
東京都,1306,区東北部,いいえ,15316,19256,19735,16805,13515,11745,15405,111777,15303,18454,18845,16434,13461,13534,20015,116046
東京都,1307,区東部,はい,13168,14142,12602,7968,4276,2381,1999,56536,6728,7362,6878,4271,2598,1574,1606,31017
東京都,1307,区東部,いいえ,21333,26525,28066,23111,16124,12220,15111,142490,20689,24622,24705,18756,13895,13512,20341,136520
東京都,1308,西多摩,はい,2110,2518,2345,1484,936,620,490,10503,1024,1266,1345,977,592,398,429,6031
東京都,1308,西多摩,いいえ,3955,5277,6198,5504,4751,4845,7001,37531,3645,4958,5418,4821,4570,5439,8380,37231
東京都,1309,南多摩,はい,8772,10074,9172,6054,3253,1897,1671,40893,4096,4856,4836,3347,2093,1404,1495,22127
東京都,1309,南多摩,いいえ,17102,21888,24584,21461,16604,14462,20439,136540,16473,21038,22299,18665,15704,16865,26128,137172
東京都,1310,北多摩西部,はい,4195,4589,4077,2823,1531,886,694,18795,1970,2144,2191,1660,988,646,685,10284
東京都,1310,北多摩西部,いいえ,8311,10242,10800,10045,7870,6420,8546,62234,7470,9222,9554,8244,6846,7042,10833,59211
東京都,1311,北多摩南部,はい,7490,7289,6329,4462,2437,1389,1166,30562,3732,3938,3720,2677,1643,1017,1033,17760
東京都,1311,北多摩南部,いいえ,14690,16812,17818,16244,12254,9566,12453,99837,15118,17332,17623,14696,11776,11107,15717,103369
東京都,1312,北多摩北部,はい,4722,4923,4342,3143,1815,1037,885,20867,2280,2508,2575,1942,1178,733,770,11986
東京都,1312,北多摩北部,いいえ,9318,11368,12156,11217,9104,7561,9835,70559,9098,11001,11644,10362,8776,8737,12736,72354
東京都,1313,島しょ,はい,143,156,139,89,72,50,52,701,90,92,89,52,56,33,31,443
東京都,1313,島しょ,いいえ,216,264,283,302,245,297,354,1961,249,274,274,213,250,314,391,1965
神奈川県,1404,川崎北部,はい,6389,6524,5801,3810,1871,908,647,25950,2927,3150,3156,2048,1095,550,532,13458
神奈川県,1404,川崎北部,いいえ,11903,14278,15385,13669,9302,6206,6661,77404,11419,13386,13650,10967,7863,6015,7733,71033
神奈川県,1405,川崎南部,はい,6071,6269,5104,3091,1626,800,553,23514,2753,2743,2478,1534,846,436,392,11182
神奈川県,1405,川崎南部,いいえ,10799,12936,12379,9861,6935,4503,4317,61730,9374,10344,9522,7284,5047,3846,4632,50049
神奈川県,1406,横須賀・三浦,はい,3352,4232,3981,2597,1578,910,666,17316,1702,2254,2266,1578,938,564,559,9861
神奈川県,1406,横須賀・三浦,いいえ,6876,10008,11218,10287,8605,6532,8062,61588,6585,8998,9894,8146,6749,6597,9321,56290
神奈川県,1407,湘南東部,はい,4721,5206,4663,3097,1563,750,616,20616,2045,2485,2360,1601,847,505,515,10358
神奈川県,1407,湘南東部,いいえ,9559,12362,13212,11487,8696,6222,8592,70130,8800,10919,10958,8819,6991,6856,11359,64702
神奈川県,1408,湘南西部,はい,3315,3789,3388,2305,1255,664,515,15231,1364,1819,1637,1065,713,419,389,7406
神奈川県,1408,湘南西部,いいえ,6602,8494,9142,8282,6816,5785,7920,53041,5645,7249,7526,6489,5482,5968,9289,47648
神奈川県,1409,県央,はい,5837,6746,5867,3764,1998,992,796,26000,2217,3009,2745,1747,1080,644,690,12132
神奈川県,1409,県央,いいえ,10769,13714,14665,12614,9645,7332,10062,78801,8559,11081,11349,9197,7368,7632,12871,68057
神奈川県,1410,相模原,はい,4559,5212,4617,3004,1649,853,614,20508,1997,2383,2367,1626,887,593,524,10377
神奈川県,1410,相模原,いいえ,8461,10663,11425,10091,7617,5722,6956,60935,7042,8797,9049,7760,6152,5519,8203,52522
神奈川県,1411,県西,はい,1989,2402,2168,1441,855,444,316,9615,810,983,945,677,446,242,280,4383
神奈川県,1411,県西,いいえ,4103,5136,5654,5457,4182,3098,4097,31727,3078,4084,4365,3572,3168,3348,4950,26565
神奈川県,1412,横浜,はい,26020,28817,26403,17114,9156,4151,2742,114403,11480,13464,13361,8855,4903,2457,1960,56480
神奈川県,1412,横浜,いいえ,49232,62766,69064,60983,45249,30940,32762,350996,45054,56304,59359,47877,35374,28038,35087,307093
新潟県,1501,下越,はい,1221,1213,1063,775,563,309,242,5386,495,610,532,385,283,173,148,2626
新潟県,1501,下越,いいえ,2667,3205,3304,3334,3296,3439,4035,23280,2509,3045,3175,3058,3180,3738,4466,23171
新潟県,1502,新潟,はい,5897,6640,5290,3704,2296,1267,835,25929,2531,2980,2532,1748,1111,667,660,12229
新潟県,1502,新潟,いいえ,12850,15898,15198,13716,12559,11363,12843,94427,11470,14217,13321,12294,11355,11785,15155,89597
新潟県,1503,県央,はい,1229,1408,1193,813,579,278,202,5702,474,608,545,365,275,170,106,2543
新潟県,1503,県央,いいえ,3253,3964,3952,3679,3428,3276,3440,24992,2836,3634,3625,3414,3131,3357,3767,23764
新潟県,1504,中越,はい,2643,2861,2323,1573,1077,575,384,11436,1115,1274,1044,760,456,272,264,5185
新潟県,1504,中越,いいえ,6649,7864,7605,7283,6948,6255,7436,50040,6193,7631,7283,6809,6646,6911,8671,50144
新潟県,1505,魚沼,はい,926,923,746,557,452,280,186,4070,384,473,378,265,176,134,113,1923
新潟県,1505,魚沼,いいえ,2178,2558,2495,2552,2856,3191,3615,19445,2143,2439,2485,2458,2633,3139,3348,18645
新潟県,1506,上越,はい,1456,1557,1272,884,580,317,241,6307,577,703,537,394,270,151,132,2764
新潟県,1506,上越,いいえ,3926,4838,4706,4581,4603,4266,4739,31659,3443,4456,4296,4071,3929,4105,4910,29210
新潟県,1507,佐渡,はい,276,297,287,223,178,144,145,1550,119,165,135,112,110,88,112,841
新潟県,1507,佐渡,いいえ,632,687,782,827,933,935,1159,5955,596,667,696,720,872,943,1176,5670
富山県,1601,新川,はい,606,744,658,457,284,169,111,3029,262,368,328,228,111,88,92,1477
富山県,1601,新川,いいえ,1745,2243,2199,1892,1844,1603,1881,13407,1516,2035,2023,1903,1684,1802,2643,13606
富山県,1602,富山,はい,2825,3500,2971,1843,1064,571,354,13128,1192,1501,1336,964,574,341,303,6211
富山県,1602,富山,いいえ,7797,10042,9693,8046,6905,5546,6176,54205,6721,8670,8408,6999,6034,5648,7413,49893
富山県,1603,高岡,はい,1621,2044,1642,1002,628,364,348,7649,674,888,769,515,362,242,285,3735
富山県,1603,高岡,いいえ,4585,6054,5715,4987,4326,4110,5670,35447,3622,5014,5075,4303,4121,4722,7476,34333
富山県,1604,砺波,はい,566,640,518,384,284,163,137,2692,241,305,244,204,144,100,110,1348
富山県,1604,砺波,いいえ,1656,2218,2002,1849,1877,1829,2645,14076,1503,1969,1935,1802,1921,2335,3266,14731
石川県,1701,南加賀,はい,1208,1567,1243,875,524,282,294,5993,544,783,678,481,360,187,232,3265
石川県,1701,南加賀,いいえ,3064,4124,3686,3220,2833,2441,3292,22660,2810,3652,3570,3183,2793,2877,4191,23076
石川県,1702,石川中央,はい,4476,5165,4317,2655,1645,869,723,19850,2036,2627,2292,1617,1006,580,593,10751
石川県,1702,石川中央,いいえ,10033,12833,12102,10198,8771,7137,8661,69735,9249,11639,11014,9151,8208,7843,11009,68113
石川県,1703,能登中部,はい,458,544,473,340,242,173,128,2358,193,266,251,191,160,104,128,1293
石川県,1703,能登中部,いいえ,1183,1632,1499,1436,1439,1524,2189,10902,1071,1536,1419,1455,1507,1971,2742,11701
石川県,1704,能登北部,はい,179,238,187,181,163,97,81,1126,92,128,129,91,83,62,57,642
石川県,1704,能登北部,いいえ,461,665,665,729,800,953,1343,5616,470,586,650,703,828,1064,1603,5904
福井県,1801,福井・坂井,はい,2258,2497,2036,1408,898,444,236,9777,871,1090,1030,692,457,202,130,4472
福井県,1801,福井・坂井,いいえ,5498,6826,6572,5890,5204,3538,2966,36494,4741,5989,5849,5166,4224,2908,2554,31431
福井県,1802,奥越,はい,270,294,262,153,132,84,43,1238,139,150,125,98,62,44,31,649
福井県,1802,奥越,いいえ,729,870,782,823,833,817,830,5684,696,795,829,876,866,879,926,5867
福井県,1803,丹南,はい,1071,1169,902,582,363,175,111,4373,444,486,438,276,182,103,71,2000
福井県,1803,丹南,いいえ,2833,3326,3028,2759,2363,1711,1717,17737,2401,2867,2803,2497,2186,1718,2022,16494
福井県,1804,嶺南,はい,656,695,593,377,269,152,124,2866,254,302,289,171,121,82,63,1282
福井県,1804,嶺南,いいえ,1731,2086,2051,2024,1961,1672,1742,13267,1312,1789,1671,1636,1513,1642,2023,11586
山梨県,1901,中北,はい,3242,3451,2946,2011,1211,627,387,13875,1461,1711,1570,1123,729,436,267,7297
山梨県,1901,中北,いいえ,5885,7468,7709,7298,6385,6208,6765,47718,5792,7504,7472,6984,6598,6872,8015,49237
山梨県,1902,峡東,はい,803,949,837,552,404,206,132,3883,387,473,489,339,204,130,80,2102
山梨県,1902,峡東,いいえ,1530,1999,2217,2047,1974,1967,2265,13999,1617,2054,2205,2089,2017,2204,2401,14587
山梨県,1903,峡南,はい,246,274,284,220,161,94,70,1349,96,136,131,123,104,55,51,696
山梨県,1903,峡南,いいえ,566,709,762,825,936,1029,1182,6009,536,727,808,870,912,1086,1307,6246
山梨県,1904,富士・東部,はい,1032,1153,1092,795,494,266,176,5008,465,530,576,433,310,154,93,2561
山梨県,1904,富士・東部,いいえ,1888,2304,2764,2975,2777,2536,2594,17838,1789,2293,2678,2724,2601,2559,2691,17335
長野県,2001,佐久,はい,1138,1132,1009,667,435,264,172,4817,484,540,499,370,218,140,109,2360
長野県,2001,佐久,いいえ,2751,3230,3231,3183,3099,2870,3355,21719,2558,2940,3047,2922,2912,3000,3616,20995
長野県,2002,上小,はい,987,1140,888,604,364,206,121,4310,417,505,460,352,229,105,103,2171
長野県,2002,上小,いいえ,2458,3267,3215,2894,2594,2385,2648,19461,2132,2815,2864,2604,2522,2525,3133,18595
長野県,2003,諏訪,はい,1012,1265,1185,760,454,258,188,5122,431,615,554,365,246,136,126,2473
長野県,2003,諏訪,いいえ,2637,3407,3334,2858,2479,2306,2955,19976,2357,3269,3213,2718,2539,2549,3609,20254
長野県,2004,上伊那,はい,933,1170,937,648,415,238,154,4495,405,448,384,271,205,140,80,1933
長野県,2004,上伊那,いいえ,2901,3651,3459,3052,2943,2564,3123,21693,2576,3395,3332,2963,2765,2774,3676,21481
長野県,2005,飯伊,はい,857,915,798,573,376,231,144,3894,331,405,370,289,152,101,83,1731
長野県,2005,飯伊,いいえ,2292,2717,2764,2598,2343,2343,2409,17466,2093,2571,2536,2486,2511,2443,2543,17183
長野県,2006,木曽,はい,112,117,79,101,52,37,35,533,41,38,38,33,32,17,19,218
長野県,2006,木曽,いいえ,286,409,450,488,447,549,701,3330,279,297,355,395,438,503,739,3006
長野県,2007,松本,はい,2444,2764,2277,1530,887,486,282,10670,956,1272,1130,744,486,265,192,5045
長野県,2007,松本,いいえ,6140,7830,7827,6653,5342,4237,4276,42305,5161,6684,6715,5796,4905,4122,4611,37994
長野県,2008,大北,はい,262,316,259,203,117,78,57,1292,112,145,128,85,62,48,40,620
長野県,2008,大北,いいえ,738,973,1025,982,910,868,1109,6605,621,904,950,962,881,841,1127,6286
長野県,2009,長野,はい,3153,3496,2988,1911,1148,590,405,13691,1226,1582,1402,951,598,362,328,6449
長野県,2009,長野,いいえ,7758,9902,10061,9032,8033,6957,8374,60117,6799,9013,9184,8292,7306,7642,10226,58462
長野県,2010,北信,はい,401,475,441,308,226,103,95,2049,192,224,219,163,99,63,60,1020
長野県,2010,北信,いいえ,1119,1325,1322,1407,1368,1426,1616,9583,1087,1395,1332,1436,1438,1450,1596,9734
岐阜県,2101,岐阜,はい,3572,4233,3443,2209,1205,600,379,15641,1359,1741,1612,1042,633,316,283,6986
岐阜県,2101,岐阜,いいえ,10943,13853,13866,11587,9340,6832,7163,73584,8785,11429,11722,9672,7770,6430,7820,63628
岐阜県,2102,西濃,はい,1775,1991,1602,1093,647,359,293,7760,647,767,721,492,316,183,191,3317
岐阜県,2102,西濃,いいえ,5010,6499,6442,5653,5088,4470,5199,38361,3960,5223,5229,4832,4605,4668,6192,34709
岐阜県,2103,中濃,はい,1713,1928,1545,1000,671,354,291,7502,591,742,679,426,318,208,182,3146
岐阜県,2103,中濃,いいえ,5287,6601,6319,5514,5359,5031,5746,39857,4066,5249,5369,5065,4995,5089,5916,35749
岐阜県,2104,東濃,はい,1546,1867,1520,1084,671,376,259,7323,568,727,685,493,326,191,190,3180
岐阜県,2104,東濃,いいえ,4659,5873,5980,5572,4948,4378,4812,36222,3733,4869,5159,4846,4754,4498,5752,33611
岐阜県,2105,飛騨,はい,634,754,655,439,317,128,90,3017,258,329,294,223,153,69,56,1382
岐阜県,2105,飛騨,いいえ,1877,2396,2346,2216,1948,1284,1186,13253,1668,2191,2265,2112,1682,1255,1171,12344
静岡県,2201,賀茂,はい,244,293,339,246,156,90,69,1437,80,151,170,128,86,68,70,753
静岡県,2201,賀茂,いいえ,419,624,743,701,687,742,921,4837,410,576,638,592,634,793,1116,4759
静岡県,2202,熱海伊東,はい,363,537,510,413,307,200,220,2550,203,311,332,271,226,155,201,1699
静岡県,2202,熱海伊東,いいえ,567,916,1112,1036,1115,1124,1817,7687,646,911,1129,1073,1126,1406,2563,8854
静岡県,2203,駿東田方,はい,3984,4521,3954,2734,1508,811,476,17988,1693,2044,1883,1400,828,471,374,8693
静岡県,2203,駿東田方,いいえ,8193,10478,10863,9678,8177,6089,6359,59837,6769,8979,9238,8081,6841,6059,7357,53324
静岡県,2204,富士,はい,2624,2808,2464,1642,913,503,293,11247,949,1246,1162,755,488,281,211,5092
静岡県,2204,富士,いいえ,5323,6763,7059,6294,5406,4413,5015,40273,4170,5433,5787,5262,4577,4480,5593,35302
静岡県,2205,静岡,はい,4070,4765,4161,2783,1603,893,690,18965,1731,2054,1993,1416,949,525,441,9109
静岡県,2205,静岡,いいえ,9167,12230,12927,11206,9916,7961,9110,72517,8401,10837,11445,9794,8456,7687,9662,66282
静岡県,2206,志太榛原,はい,2484,2772,2190,1478,932,432,269,10557,1022,1120,1021,678,459,227,165,4692
静岡県,2206,志太榛原,いいえ,6366,7917,7804,7012,6521,5299,5662,46581,5550,6928,6718,6122,5751,5136,6064,42269
静岡県,2207,中東遠,はい,2707,2929,2112,1494,845,437,277,10801,940,1090,890,581,414,221,191,4327
静岡県,2207,中東遠,いいえ,8113,9280,8532,7490,7219,5992,6445,53071,6578,7734,7188,6342,6471,6173,6871,47357
静岡県,2208,西部,はい,4636,4992,4166,2711,1702,893,607,19707,1797,2095,1987,1296,836,474,403,8888
静岡県,2208,西部,いいえ,14181,16941,17138,15037,12820,9806,10770,96693,11552,14386,14744,12188,10918,9698,11410,84896
愛知県,2302,海部,はい,1634,2040,1798,1113,601,327,255,7768,594,818,714,413,264,163,192,3158
愛知県,2302,海部,いいえ,4064,5831,6047,4849,3739,3172,4406,32108,3208,4579,4719,3874,3367,3529,5943,29219
愛知県,2304,尾張東部,はい,2657,2979,2545,1536,831,394,314,11256,963,1191,1057,709,417,219,249,4805
愛知県,2304,尾張東部,いいえ,7662,9444,9583,7657,5982,4519,6180,51027,6431,7765,7827,6104,4993,5080,7775,45975
愛知県,2305,尾張西部,はい,2399,2978,2510,1685,840,501,434,11347,919,1131,1040,740,431,252,315,4828
愛知県,2305,尾張西部,いいえ,6686,9091,9425,7907,6186,5509,7663,52467,5850,8000,8296,6940,5996,6449,10058,51589
愛知県,2306,尾張北部,はい,3746,4388,3786,2367,1252,624,461,16624,1262,1652,1557,928,563,332,379,6673
愛知県,2306,尾張北部,いいえ,9811,13142,13218,10591,8064,6703,8764,70293,7918,10683,10777,8414,6796,7285,11088,62961
愛知県,2307,知多半島,はい,3557,4195,3372,2134,1169,702,615,15744,1364,1654,1519,1025,581,387,386,6916
愛知県,2307,知多半島,いいえ,10083,12747,12314,10559,8362,7045,9553,70663,8076,10195,10058,8329,7363,7772,11730,63523
愛知県,2308,西三河北部,はい,3089,3264,2769,1783,910,436,294,12545,1071,1328,1148,699,409,230,201,5086
愛知県,2308,西三河北部,いいえ,9131,10514,10825,9162,7135,4670,5972,57409,6489,7996,8080,6239,5051,5012,6860,45727
愛知県,2309,西三河南部西,はい,4050,4437,3776,2498,1388,673,468,17290,1480,1665,1606,1091,599,302,348,7091
愛知県,2309,西三河南部西,いいえ,11188,13471,14013,11899,9136,6724,8471,74902,8948,11020,11140,9246,7119,7077,9196,63746
愛知県,2310,西三河南部東,はい,2421,2667,2304,1501,821,434,331,10479,924,1114,940,620,400,255,260,4513
愛知県,2310,西三河南部東,いいえ,6942,8239,8349,7219,6111,5138,6653,48651,5877,6973,6800,5864,5347,5568,7468,43897
愛知県,2311,東三河北部,はい,200,232,158,134,100,59,43,926,63,82,65,51,33,28,27,349
愛知県,2311,東三河北部,いいえ,703,804,817,759,781,833,1108,5805,489,642,624,653,805,922,1274,5409
愛知県,2312,東三河南部,はい,3197,3627,3108,1998,1165,643,477,14215,1178,1437,1388,915,597,348,300,6163
愛知県,2312,東三河南部,いいえ,8970,11156,11485,9808,8337,6540,7862,64158,6933,8716,8890,7691,7224,7102,9733,56289
愛知県,2313,名古屋・尾張中部,はい,15003,16107,13891,8605,4647,2397,1772,62422,6020,6744,6138,4007,2277,1268,1186,27640
愛知県,2313,名古屋・尾張中部,いいえ,35300,42005,42684,36591,28415,20471,23364,228830,29198,34905,35372,29169,23226,20218,27033,199121
三重県,2401,北勢,はい,4933,5759,4785,3153,1764,863,684,21941,1780,2243,2061,1341,815,470,522,9232
三重県,2401,北勢,いいえ,12089,16091,16605,14398,11575,9497,12461,92716,9962,13097,13401,11446,9885,10483,15250,83524
三重県,2402,中勢伊賀,はい,2302,2611,2223,1360,948,547,387,10378,923,1066,968,776,507,279,279,4798
三重県,2402,中勢伊賀,いいえ,5898,7260,7241,6511,6208,5621,6656,45395,5029,6339,6403,5689,5814,6091,8040,43405
三重県,2403,南勢志摩,はい,2052,2439,2030,1447,896,573,459,9896,881,1121,1004,749,516,341,348,4960
三重県,2403,南勢志摩,いいえ,5287,6914,7099,6656,6158,5817,7427,45358,4622,6231,6434,6087,6046,6981,9429,45830
三重県,2404,東紀州,はい,242,298,239,203,119,88,75,1264,73,140,120,122,87,41,71,654
三重県,2404,東紀州,いいえ,578,848,901,863,878,1022,1289,6379,535,670,768,798,930,1130,1735,6566
滋賀県,2501,大津,はい,1891,2133,1819,1109,637,389,280,8258,939,1049,942,631,410,202,177,4350
滋賀県,2501,大津,いいえ,4993,6210,6043,5505,4796,3827,4483,35857,5052,6036,6075,5154,4535,3868,5128,35848
滋賀県,2502,湖南,はい,2415,2519,2026,1265,618,303,223,9369,913,1059,883,492,278,159,148,3932
滋賀県,2502,湖南,いいえ,5524,6640,6087,5036,3835,3201,3982,34305,5378,6258,5583,4210,3498,3504,5152,33583
滋賀県,2503,甲賀,はい,1096,1120,927,620,382,178,134,4457,299,390,320,207,168,88,73,1545
滋賀県,2503,甲賀,いいえ,1993,2440,2368,2116,2104,1961,2409,15391,1813,2136,2025,1983,2092,2081,2762,14892
滋賀県,2504,東近江,はい,1594,1463,1251,768,517,236,167,5996,456,530,450,319,193,124,94,2166
滋賀県,2504,東近江,いいえ,3157,3746,3381,3147,3006,2660,3076,22173,3006,3378,3201,3063,2970,2879,3463,21960
滋賀県,2505,湖東,はい,951,1082,790,480,307,179,109,3898,326,436,308,220,160,94,76,1620
滋賀県,2505,湖東,いいえ,2192,2490,2365,2035,1914,1579,1665,14240,1906,2236,2224,1940,1858,1740,1986,13890
滋賀県,2506,湖北,はい,763,953,747,529,304,152,83,3531,345,386,365,240,136,95,65,1632
滋賀県,2506,湖北,いいえ,2193,2518,2480,2269,2129,1789,1907,15285,1955,2292,2375,2269,2123,1959,2100,15073
滋賀県,2507,湖西,はい,210,213,214,155,119,35,33,979,90,125,101,67,59,20,18,480
滋賀県,2507,湖西,いいえ,473,612,685,679,736,547,536,4268,504,601,695,760,693,566,663,4482
京都府,2601,丹後,はい,452,590,526,366,261,149,119,2463,167,270,218,139,105,66,58,1023
京都府,2601,丹後,いいえ,992,1367,1429,1452,1432,1322,1578,9572,974,1376,1497,1487,1456,1454,1746,9990
京都府,2602,中丹,はい,956,1107,892,609,417,226,198,4405,395,508,411,308,207,121,144,2094
京都府,2602,中丹,いいえ,2129,2808,2715,2484,2394,2186,2782,17498,1811,2532,2541,2194,2324,2194,3358,16954
京都府,2603,南丹,はい,645,735,567,409,260,174,119,2909,236,372,310,202,131,89,80,1420
京都府,2603,南丹,いいえ,1564,1872,1849,1701,1774,1696,2113,12569,1403,1731,1806,1759,1860,1758,2357,12674
京都府,2604,京都・乙訓,はい,8115,9435,7957,5065,3071,1554,1189,36386,4013,4711,4212,2887,1628,935,881,19267
京都府,2604,京都・乙訓,いいえ,17767,22326,22917,19674,16512,12206,14455,125857,17590,21362,21275,17943,14315,12118,16348,120951
京都府,2605,山城北,はい,2399,2885,2540,1489,780,441,430,10964,994,1317,1155,800,486,307,325,5384
京都府,2605,山城北,いいえ,5091,7183,6717,5683,4833,4429,6301,40237,4737,6333,6045,5106,4549,5176,8695,40641
京都府,2606,山城南,はい,648,709,578,345,201,117,93,2691,258,297,276,174,103,72,79,1259
京都府,2606,山城南,いいえ,1636,2101,2016,1654,1487,1321,1766,11981,1461,1852,1674,1483,1308,1418,2079,11275
大阪府,2701,豊能,はい,5850,6273,5435,3428,1894,803,587,24270,2354,2713,2608,1667,875,459,507,11183
大阪府,2701,豊能,いいえ,12484,15591,16163,13353,10293,7529,9176,84589,11546,14382,14672,11439,8500,7643,10704,78886
大阪府,2702,三島,はい,3829,4522,3920,2256,1265,596,430,16818,1653,1980,1810,1073,635,374,344,7869
大阪府,2702,三島,いいえ,8727,11471,11572,8993,7331,5619,7099,60812,8094,10370,10221,7643,6293,5935,8565,57121
大阪府,2703,北河内,はい,4981,6125,5355,3370,1793,744,375,22743,2084,2770,2580,1557,791,327,218,10327
大阪府,2703,北河内,いいえ,10618,14451,15041,12401,9436,5616,4359,71922,9160,12326,12816,9874,6508,3993,3910,58587
大阪府,2704,中河内,はい,3791,4464,4102,2498,1307,588,385,17135,1547,2016,2017,1304,708,368,283,8243
大阪府,2704,中河内,いいえ,7347,10193,10887,9068,6997,4635,4979,54106,6379,9016,9561,8050,6034,4755,5978,49773
大阪府,2705,南河内,はい,2081,2535,2427,1605,949,431,291,10319,880,1183,1195,763,464,249,187,4921
大阪府,2705,南河内,いいえ,4605,6494,7066,6489,5745,4606,5118,40123,4284,5843,6371,5593,4610,4287,5701,36689
大阪府,2706,堺市,はい,3723,4808,4070,2486,1491,764,525,17867,1839,2372,2149,1433,867,476,410,9546
大阪府,2706,堺市,いいえ,8313,11604,11918,9362,7293,5814,7819,62123,7755,10290,10173,8029,6299,6595,10405,59546
大阪府,2707,泉州,はい,3700,4467,4158,2446,1386,656,440,17253,1584,2008,1982,1209,669,335,284,8071
大阪府,2707,泉州,いいえ,7825,11158,11759,10031,8037,6123,6608,61541,6948,9683,10064,8169,6363,5857,7202,54286
大阪府,2708,大阪市,はい,17705,18576,15844,9599,5148,2115,1139,70126,10253,10979,9690,6563,3217,1105,622,42429
大阪府,2708,大阪市,いいえ,30681,37970,39911,32850,24395,14300,10659,190766,30390,36128,36415,29756,20423,11048,9474,173634
兵庫県,2801,神戸,はい,8105,9251,7926,5205,3169,1551,1197,36404,3698,4514,3952,2803,1690,908,896,18461
兵庫県,2801,神戸,いいえ,17969,23144,24064,20679,18103,14737,17274,135970,16971,21235,21470,18280,16025,14871,19943,128795
兵庫県,2804,東播磨,はい,3534,3830,3349,2049,1125,563,345,14795,1397,1582,1476,904,518,285,243,6405
兵庫県,2804,東播磨,いいえ,9550,11730,11559,9488,8082,6547,7565,64521,7357,9365,9372,7538,6313,6380,8556,54881
兵庫県,2805,北播磨,はい,1077,1280,1074,680,444,210,166,4931,436,509,471,300,188,114,92,2110
兵庫県,2805,北播磨,いいえ,2928,3693,3693,3448,3073,2817,3209,22861,2449,3205,3211,2976,2844,2848,3440,20973
兵庫県,2808,但馬,はい,825,936,748,544,391,248,145,3837,291,389,379,237,193,94,75,1658
兵庫県,2808,但馬,いいえ,1887,2405,2336,2257,2539,2446,2880,16750,1758,2317,2430,2466,2582,2734,3100,17387
兵庫県,2809,丹波,はい,429,505,376,255,200,107,52,1924,182,164,156,134,85,54,39,814
兵庫県,2809,丹波,いいえ,1181,1363,1296,1225,1381,1271,1427,9144,979,1243,1264,1251,1387,1324,1478,8926
兵庫県,2810,淡路,はい,556,618,482,394,259,136,105,2550,234,300,242,172,113,85,53,1199
兵庫県,2810,淡路,いいえ,1198,1538,1553,1484,1619,1726,1995,11113,1324,1594,1571,1510,1795,1920,2329,12043
兵庫県,2811,阪神,はい,8448,9865,8943,5694,3192,1364,983,38489,3588,4551,4263,2773,1524,762,712,18173
兵庫県,2811,阪神,いいえ,18416,24904,26388,22485,17637,13109,14723,137662,17640,23120,24040,19072,14800,12390,16224,127286
兵庫県,2812,播磨姫路,はい,3879,4372,3707,2304,1438,744,558,17002,1482,1931,1682,1085,707,457,392,7736
兵庫県,2812,播磨姫路,いいえ,9793,12629,11963,10962,9595,8451,10536,73929,7871,10554,10171,9137,8316,9132,13014,68195
奈良県,2901,奈良,はい,1431,1702,1551,979,578,284,168,6693,715,842,846,569,292,159,133,3556
奈良県,2901,奈良,いいえ,3378,4518,4901,4491,3893,2850,2889,26920,3565,4653,4944,4113,3218,2767,3209,26469
奈良県,2902,東和,はい,762,949,761,502,312,167,123,3576,364,410,448,262,167,102,99,1852
奈良県,2902,東和,いいえ,1668,2282,2448,2315,2141,2010,2481,15345,1740,2149,2246,2176,2087,2156,2913,15467
奈良県,2903,西和,はい,1427,1788,1541,893,558,287,225,6719,637,821,675,471,296,190,189,3279
奈良県,2903,西和,いいえ,3600,4822,4982,4356,3680,3208,4504,29152,3540,4531,4601,3841,3396,3825,5994,29728
奈良県,2904,中和,はい,1611,1765,1552,997,548,292,216,6981,747,827,830,534,342,199,193,3672
奈良県,2904,中和,いいえ,3750,4975,5272,4633,4031,3479,4248,30388,3652,4683,4925,4334,3714,3834,5305,30447
奈良県,2905,南和,はい,198,215,204,164,109,64,63,1017,113,128,97,97,61,29,25,550
奈良県,2905,南和,いいえ,413,605,721,737,862,742,702,4782,436,605,643,784,823,722,804,4817
和歌山県,3001,和歌山,はい,1845,2185,1835,1196,769,430,381,8641,738,952,931,640,402,277,272,4212
和歌山県,3001,和歌山,いいえ,4516,5889,5890,5310,4781,4101,5249,35736,3501,4571,4708,4375,3919,4407,6733,32214
和歌山県,3002,那賀,はい,486,524,492,346,216,121,73,2258,202,221,255,183,100,67,60,1088
和歌山県,3002,那賀,いいえ,1037,1477,1467,1348,1346,1256,1529,9460,937,1285,1359,1352,1282,1392,1800,9407
和歌山県,3003,橋本,はい,312,373,302,221,168,75,77,1528,158,192,170,94,102,55,53,824
和歌山県,3003,橋本,いいえ,674,956,932,963,1033,1107,1250,6915,637,881,957,972,1044,1143,1465,7099
和歌山県,3004,有田,はい,255,308,239,155,112,64,53,1186,145,132,135,101,60,26,32,631
和歌山県,3004,有田,いいえ,707,911,901,876,824,822,1001,6042,683,815,916,836,850,964,1075,6139
和歌山県,3005,御坊,はい,285,333,243,174,103,65,55,1258,110,142,106,73,65,29,34,559
和歌山県,3005,御坊,いいえ,682,881,840,824,852,842,910,5831,604,742,783,776,772,929,984,5590
和歌山県,3006,田辺,はい,538,669,513,372,231,138,96,2557,249,303,295,195,113,74,60,1289
和歌山県,3006,田辺,いいえ,1159,1540,1551,1545,1583,1388,1541,10307,1202,1459,1469,1615,1534,1513,1852,10644
和歌山県,3007,新宮,はい,198,246,221,152,106,57,47,1027,81,116,112,86,56,42,26,519
和歌山県,3007,新宮,いいえ,456,671,705,700,731,680,990,4933,419,531,601,650,706,874,1263,5044
鳥取県,3101,東部,はい,1198,1275,988,726,540,287,179,5193,474,535,497,339,236,157,119,2357
鳥取県,3101,東部,いいえ,2911,3496,3053,2966,2968,2850,3045,21289,2772,3270,3028,2905,2974,3149,3554,21652
鳥取県,3102,中部,はい,462,472,380,289,212,145,96,2056,186,220,145,135,109,76,67,938
鳥取県,3102,中部,いいえ,1055,1175,1143,1146,1201,1143,1213,8076,982,1261,1134,1108,1213,1280,1431,8409
鳥取県,3103,西部,はい,1166,1280,996,683,502,307,159,5093,555,626,495,392,240,136,129,2573
鳥取県,3103,西部,いいえ,2623,3146,3019,2891,2811,2438,2681,19609,2445,2972,2812,2607,2563,2489,3265,19153
島根県,3201,松江,はい,1231,1290,1155,674,472,263,193,5278,542,628,536,369,234,154,146,2609
島根県,3201,松江,いいえ,2942,3692,3554,3234,3172,2870,3354,22818,2881,3699,3456,3162,3079,3042,4083,23402
島根県,3202,雲南,はい,198,241,170,138,106,64,57,974,100,89,88,65,41,37,32,452
島根県,3202,雲南,いいえ,719,897,757,750,949,964,1114,6150,678,815,742,779,874,866,1124,5878
島根県,3203,出雲,はい,862,909,742,478,347,224,150,3712,369,381,325,222,146,112,88,1643
島根県,3203,出雲,いいえ,2213,2662,2396,2293,2311,2206,2714,16795,2184,2603,2264,2246,2261,2486,3042,17086
島根県,3204,大田,はい,233,254,175,154,105,69,54,1044,87,115,87,62,54,36,30,471
島根県,3204,大田,いいえ,569,687,632,610,756,803,1007,5064,529,681,633,655,824,906,1138,5366
島根県,3205,浜田,はい,372,413,335,248,164,116,104,1752,160,181,148,134,71,58,65,817
島根県,3205,浜田,いいえ,860,1103,964,973,1191,1193,1529,7813,810,1022,969,932,1127,1255,1754,7869
島根県,3206,益田,はい,266,285,197,180,120,102,67,1217,123,132,97,65,66,52,55,590
島根県,3206,益田,いいえ,690,840,689,751,910,1016,1287,6183,561,737,671,709,842,1088,1506,6114
島根県,3207,隠岐,はい,112,123,74,74,37,36,23,479,44,58,55,23,17,22,21,240
島根県,3207,隠岐,いいえ,241,237,195,215,254,303,385,1830,226,259,204,234,248,323,446,1940
岡山県,3301,県南東部,はい,5026,5541,4422,2940,1721,929,639,21218,2362,2645,2276,1535,986,566,512,10882
岡山県,3301,県南東部,いいえ,11158,14619,13489,11527,10599,9232,10161,80785,10350,13137,12595,10760,9954,9515,12170,78481
岡山県,3302,県南西部,はい,3513,4019,3229,1971,1293,644,451,15120,1511,2007,1515,966,623,383,309,7314
岡山県,3302,県南西部,いいえ,8891,11492,10748,8838,7861,6945,7302,62077,7538,9920,9532,7611,7065,6889,8603,57158
岡山県,3303,高梁・新見,はい,207,258,200,162,140,88,34,1089,99,113,74,72,70,46,31,505
岡山県,3303,高梁・新見,いいえ,533,664,650,662,845,807,843,5004,469,609,577,633,797,807,882,4774
岡山県,3304,真庭,はい,193,196,152,111,92,40,53,837,78,87,90,48,37,18,25,383
岡山県,3304,真庭,いいえ,515,607,497,516,674,673,752,4234,477,529,488,601,674,756,857,4382
岡山県,3305,津山・英田,はい,784,908,678,422,341,167,118,3418,399,425,362,259,203,116,82,1846
岡山県,3305,津山・英田,いいえ,1845,2267,2100,1751,2004,2017,2270,14254,1730,2148,1997,1834,2105,2120,2573,14507
広島県,3401,広島,はい,7447,8624,7279,4567,2449,903,449,31718,3126,3687,3251,1984,1093,432,240,13813
広島県,3401,広島,いいえ,18113,23348,23186,19401,15426,9060,6473,115007,15239,19452,18736,14633,10485,6254,5173,89972
広島県,3402,広島西,はい,670,712,603,391,266,116,80,2838,276,312,302,191,141,84,36,1342
広島県,3402,広島西,いいえ,1556,2025,1928,1838,1789,1459,1381,11976,1346,1729,1696,1535,1450,1255,1195,10206
広島県,3403,呉,はい,708,993,883,620,340,212,154,3910,357,516,451,286,192,98,99,1999
広島県,3403,呉,いいえ,2218,3328,3206,2958,2660,2133,2278,18781,1888,2669,2614,2451,2087,1924,2645,16278
広島県,3404,広島中央,はい,1187,1361,1115,708,440,167,92,5070,387,558,460,275,186,81,55,2002
広島県,3404,広島中央,いいえ,3156,3954,3825,3303,2750,1908,1989,20885,2217,2932,2808,2371,2169,1715,2014,16226
広島県,3405,尾三,はい,1016,1144,918,586,410,224,123,4421,420,490,442,320,195,135,108,2110
広島県,3405,尾三,いいえ,2532,3356,3092,2816,2837,2537,2777,19947,2057,2825,2739,2518,2682,2576,3057,18454
広島県,3406,福山・府中,はい,2696,2863,2217,1431,931,417,282,10837,1006,1249,1047,673,479,233,178,4865
広島県,3406,福山・府中,いいえ,6013,7731,7025,5971,5341,4403,4429,40913,4994,6232,5984,4964,4419,4084,4625,35302
広島県,3407,備北,はい,354,374,305,210,176,104,81,1604,180,222,164,109,91,56,32,854
広島県,3407,備北,いいえ,906,1138,1042,979,1115,1174,1326,7680,851,1042,1012,1026,1161,1272,1416,7780
山口県,3501,岩国,はい,484,587,527,348,230,125,104,2405,218,314,278,169,113,78,86,1256
山口県,3501,岩国,いいえ,1196,1692,1688,1582,1551,1443,1694,10846,1024,1400,1542,1341,1304,1474,1943,10028
山口県,3502,柳井,はい,264,361,270,178,143,73,53,1342,112,177,151,81,57,43,39,660
山口県,3502,柳井,いいえ,739,999,955,819,878,859,862,6111,633,838,908,773,838,868,1055,5913
山口県,3503,周南,はい,1147,1338,1208,682,508,259,211,5353,452,603,571,398,261,152,154,2591
山口県,3503,周南,いいえ,2915,4099,3842,3121,2750,2474,3081,22282,2434,3433,3252,2652,2510,2705,4011,20997
山口県,3504,山口・防府,はい,1688,1949,1617,997,657,318,202,7428,677,773,650,442,305,181,121,3149
山口県,3504,山口・防府,いいえ,3968,5076,4658,4221,4003,3083,3176,28185,3043,3836,3748,3213,3023,2730,3227,22820
山口県,3505,宇部・小野田,はい,1206,1422,1080,742,482,302,199,5433,497,607,559,391,273,147,155,2629
山口県,3505,宇部・小野田,いいえ,2760,3495,3258,2979,2771,2366,2619,20248,2226,2637,2789,2438,2288,2430,3102,17910
山口県,3506,下関,はい,1236,1471,1062,733,532,240,107,5381,489,670,618,470,290,122,70,2729
山口県,3506,下関,いいえ,2409,3164,2980,2707,2442,1793,1152,16647,2010,2527,2625,2377,1975,1239,980,13733
山口県,3507,長門,はい,189,193,164,80,88,50,28,792,66,78,69,60,50,27,14,364
山口県,3507,長門,いいえ,332,420,363,343,413,387,459,2717,308,370,397,369,453,463,554,2914
山口県,3508,萩,はい,186,261,200,148,108,79,48,1030,65,100,80,82,53,41,40,461
山口県,3508,萩,いいえ,444,568,560,546,639,676,745,4178,375,524,579,539,626,754,914,4311
徳島県,3601,東部,はい,2463,2669,2142,1514,1001,547,470,10806,1101,1325,1134,803,517,432,354,5666
徳島県,3601,東部,いいえ,5277,6604,6431,6077,5698,5448,6705,42240,5181,6446,6411,5869,5666,6623,8301,44497
徳島県,3603,南部,はい,681,719,590,418,278,198,191,3075,270,310,289,219,157,126,121,1492
徳島県,3603,南部,いいえ,1421,1812,1669,1607,1627,1819,2471,12426,1257,1567,1704,1583,1777,2201,3049,13138
徳島県,3605,西部,はい,258,296,220,156,141,117,80,1268,144,155,128,118,89,49,81,764
徳島県,3605,西部,いいえ,622,669,724,819,957,1136,1353,6280,574,723,741,848,1009,1250,1481,6626
香川県,3702,小豆,はい,91,94,85,67,36,25,32,430,58,56,47,28,16,14,15,234
香川県,3702,小豆,いいえ,231,247,241,259,277,321,479,2055,240,286,284,293,329,425,624,2481
香川県,3706,東部,はい,2831,3296,2654,1725,1083,583,443,12615,1325,1602,1410,895,573,361,390,6556
香川県,3706,東部,いいえ,6116,8130,7698,6633,6071,5312,6668,46628,5910,7700,7238,6021,5779,5862,8426,46936
香川県,3707,西部,はい,1852,2195,1669,1097,774,444,348,8379,870,1016,890,570,397,247,242,4232
香川県,3707,西部,いいえ,3956,4963,4715,4298,4439,4331,5431,32133,3720,4825,4516,4155,4398,4800,6702,33116
愛媛県,3801,宇摩,はい,450,494,400,313,162,81,39,1939,155,188,186,116,81,46,20,792
愛媛県,3801,宇摩,いいえ,931,1234,1101,1071,930,692,655,6614,815,1024,979,884,720,695,679,5796
愛媛県,3802,新居浜・西条,はい,1160,1315,983,734,475,198,124,4989,503,579,516,368,242,115,67,2390
愛媛県,3802,新居浜・西条,いいえ,2357,3102,2834,2621,2288,1659,1657,16518,2020,2530,2389,2223,1836,1602,1830,14430
愛媛県,3803,今治,はい,765,882,761,475,285,156,118,3442,309,436,410,272,152,85,68,1732
愛媛県,3803,今治,いいえ,1752,2295,2158,1905,1835,1529,1820,13294,1505,1927,1977,1719,1651,1476,2018,12273
愛媛県,3804,松山,はい,4166,4838,3684,2520,1547,718,338,17811,1860,2218,1798,1311,791,392,240,8610
愛媛県,3804,松山,いいえ,7784,9747,9415,8315,7746,5503,4391,52901,7397,8903,8730,7430,6581,5070,4662,48773
愛媛県,3805,八幡浜・大洲,はい,624,747,597,473,331,175,118,3065,281,325,292,201,160,68,55,1382
愛媛県,3805,八幡浜・大洲,いいえ,1332,1720,1609,1791,1879,1537,1577,11445,1339,1609,1796,1758,1725,1666,1779,11672
愛媛県,3806,宇和島,はい,547,607,474,379,244,137,86,2474,258,310,288,208,136,89,65,1354
愛媛県,3806,宇和島,いいえ,987,1338,1259,1318,1336,1167,1422,8827,1008,1406,1420,1424,1489,1463,1726,9936
高知県,3901,安芸,はい,224,249,186,146,120,66,65,1056,82,120,80,90,56,43,45,516
高知県,3901,安芸,いいえ,380,466,530,540,549,580,758,3803,348,461,510,509,591,773,1061,4253
高知県,3902,中央,はい,3024,3421,2653,1793,1123,656,435,13105,1507,1801,1570,989,701,382,338,7288
高知県,3902,中央,いいえ,5746,7518,6853,6315,6039,5533,6565,44569,5784,7232,6968,6353,6083,6020,7867,46307
高知県,3903,高幡,はい,243,243,216,143,115,97,58,1115,96,135,101,97,53,42,43,567
高知県,3903,高幡,いいえ,523,624,632,621,759,831,1086,5076,433,577,572,599,741,922,1145,4989
高知県,3904,幡多,はい,346,404,309,203,170,123,90,1645,165,245,186,126,98,70,63,953
高知県,3904,幡多,いいえ,698,898,812,788,940,1075,1395,6606,725,938,900,912,1056,1388,1843,7762
福岡県,4001,福岡・糸島,はい,12850,12756,10243,6449,4019,2178,1566,50061,6563,6541,5514,3569,2326,1408,1271,27192
福岡県,4001,福岡・糸島,いいえ,18413,21682,21173,18211,15418,12254,13072,120223,19296,21766,20058,16337,13326,12067,14825,117675
福岡県,4002,粕屋,はい,2379,2664,1904,1127,765,406,298,9543,1015,1132,807,566,410,225,171,4326
福岡県,4002,粕屋,いいえ,3554,4231,3515,2837,2817,2460,2428,21842,3492,3880,3255,2599,2419,2263,2469,20377
福岡県,4003,宗像,はい,1036,931,703,454,380,226,133,3863,481,433,401,256,203,107,74,1955
福岡県,4003,宗像,いいえ,1890,2004,1748,1573,1696,1577,1692,12180,1795,1936,1718,1627,1580,1636,1764,12056
福岡県,4004,筑紫,はい,2697,3011,2360,1501,950,514,415,11448,1206,1415,1255,856,560,318,304,5914
福岡県,4004,筑紫,いいえ,4611,5499,5255,4608,4372,3836,4301,32482,4710,5550,5252,4451,3931,3868,4889,32651
福岡県,4005,朝倉,はい,541,561,463,300,256,143,130,2394,245,270,230,185,123,67,75,1195
福岡県,4005,朝倉,いいえ,893,963,864,853,920,1068,1190,6751,790,951,910,933,997,1205,1387,7173
福岡県,4006,久留米,はい,2646,2746,2239,1552,1050,617,432,11282,1212,1407,1253,865,666,395,351,6149
福岡県,4006,久留米,いいえ,4168,4978,4623,4474,4522,4175,4693,31633,4223,5007,5082,4646,4314,4603,5600,33475
福岡県,4007,八女・筑後,はい,763,803,645,491,351,228,153,3434,358,413,390,293,193,124,92,1863
福岡県,4007,八女・筑後,いいえ,1311,1438,1372,1395,1580,1517,1783,10396,1245,1457,1512,1552,1601,1763,2104,11234
福岡県,4008,有明,はい,972,1028,882,667,484,294,233,4560,489,578,522,410,296,180,203,2678
福岡県,4008,有明,いいえ,1606,1843,1866,2027,2190,2169,2705,14406,1514,1889,1929,2106,2119,2611,3465,15633
福岡県,4009,飯塚,はい,1027,1100,808,549,493,326,280,4583,597,704,539,420,372,240,221,3093
福岡県,4009,飯塚,いいえ,1609,1835,1590,1510,1779,1852,2463,12638,1638,1921,1772,1564,1901,2248,3089,14133
福岡県,4010,直方・鞍手,はい,693,670,494,318,272,212,144,2803,324,341,275,214,179,112,123,1568
福岡県,4010,直方・鞍手,いいえ,1056,1154,1007,959,1132,1100,1459,7867,877,947,1038,937,1038,1274,1690,7801
福岡県,4011,田川,はい,634,662,498,372,303,204,164,2837,385,452,367,267,210,166,153,2000
福岡県,4011,田川,いいえ,898,1124,1043,925,1085,1201,1410,7686,906,1101,1054,1072,1152,1374,1662,8321
福岡県,4012,北九州,はい,6494,7070,5596,3772,2686,1823,1452,28893,3179,3766,3406,2425,1668,1167,1228,16839
福岡県,4012,北九州,いいえ,10939,13362,13141,11841,11601,10578,12769,84231,9905,12111,12415,11003,10104,10800,15675,82013
福岡県,4013,京築,はい,1061,1184,913,628,416,250,206,4658,525,599,523,366,267,171,166,2617
福岡県,4013,京築,いいえ,2002,2527,2407,2189,2249,2246,2646,16266,1664,2151,2084,1870,1988,2403,3077,15237
佐賀県,4101,中部,はい,2010,2064,1769,1249,913,536,383,8924,911,1083,963,728,582,318,277,4862
佐賀県,4101,中部,いいえ,3653,4252,4071,4135,4009,4024,4375,28519,3603,4233,4135,4018,3923,4268,4772,28952
佐賀県,4102,東部,はい,888,877,651,476,283,180,122,3477,323,359,360,210,184,127,90,1653
佐賀県,4102,東部,いいえ,1564,1769,1597,1401,1389,1379,1725,10824,1287,1551,1442,1156,1249,1490,2060,10235
佐賀県,4103,北部,はい,634,657,517,374,335,233,163,2913,359,398,304,269,243,159,123,1855
佐賀県,4103,北部,いいえ,1066,1281,1099,1197,1295,1335,1571,8844,1116,1292,1194,1315,1422,1537,1703,9579
佐賀県,4104,西部,はい,450,411,345,234,210,120,85,1855,204,219,193,137,129,109,78,1069
佐賀県,4104,西部,いいえ,857,902,869,932,953,1031,1126,6670,787,828,817,911,953,1111,1414,6821
佐賀県,4105,南部,はい,657,623,585,478,347,230,190,3110,312,293,353,231,220,171,131,1711
佐賀県,4105,南部,いいえ,1318,1486,1419,1700,1776,1903,2356,11958,1164,1424,1384,1565,1841,2253,2860,12491
長崎県,4201,長崎,はい,2341,2676,2404,1817,1356,851,665,12110,1230,1420,1393,999,749,562,555,6908
長崎県,4201,長崎,いいえ,4870,6240,6399,6065,5911,5775,7047,42307,5060,6179,6129,5903,5767,6432,8438,43908
長崎県,4202,佐世保県北,はい,1218,1258,1041,772,626,460,374,5749,678,757,659,497,369,307,295,3562
長崎県,4202,佐世保県北,いいえ,2258,2847,2700,2877,2947,3138,3817,20584,2321,2723,2814,2703,2873,3647,4638,21719
長崎県,4203,県央,はい,1543,1567,1229,945,696,396,269,6645,629,665,640,502,372,259,216,3283
長崎県,4203,県央,いいえ,2691,3320,3283,3165,3102,3110,3450,22121,2753,3135,3198,3016,2989,3437,4366,22894
長崎県,4204,県南,はい,498,542,484,366,312,220,164,2586,241,251,272,211,188,125,112,1400
長崎県,4204,県南,いいえ,1007,1198,1269,1459,1664,1741,2168,10506,1085,1341,1483,1607,1859,2274,2745,12394
長崎県,4206,五島,はい,144,132,135,113,96,82,47,749,64,77,77,59,59,44,31,411
長崎県,4206,五島,いいえ,258,329,330,353,405,496,563,2734,265,283,332,371,482,596,687,3016
長崎県,4207,上五島,はい,92,114,82,83,74,36,15,496,34,45,37,46,41,19,10,232
長崎県,4207,上五島,いいえ,203,230,245,287,293,294,272,1824,151,202,205,264,270,286,348,1726
長崎県,4208,壱岐,はい,132,147,142,92,56,48,44,661,71,85,50,62,42,45,30,385
長崎県,4208,壱岐,いいえ,223,259,267,283,342,375,485,2234,264,286,266,315,338,416,581,2466
長崎県,4209,対馬,はい,156,168,128,102,101,73,48,776,71,79,77,66,48,36,30,407
長崎県,4209,対馬,いいえ,232,291,291,295,383,462,548,2502,261,300,291,323,431,563,647,2816
熊本県,4302,宇城,はい,557,575,446,362,244,153,107,2444,246,286,253,161,138,75,43,1202
熊本県,4302,宇城,いいえ,1000,1143,1157,1321,1317,1251,1316,8505,1015,1131,1177,1192,1238,1303,1410,8466
熊本県,4303,有明,はい,826,729,554,450,321,213,142,3235,369,429,331,272,206,146,94,1847
熊本県,4303,有明,いいえ,1534,1634,1566,1617,1694,1752,1914,11711,1392,1632,1574,1602,1713,1740,2068,11721
熊本県,4304,鹿本,はい,280,257,216,166,130,72,45,1166,147,132,139,93,70,37,25,643
熊本県,4304,鹿本,いいえ,497,529,551,570,608,599,651,4005,441,525,557,572,617,634,689,4035
熊本県,4305,菊池,はい,1385,1373,933,673,417,234,160,5175,619,603,471,356,249,134,91,2523
熊本県,4305,菊池,いいえ,2589,2811,2336,2296,2240,2049,1945,16266,2526,2573,2179,2079,2023,1933,1971,15284
熊本県,4306,阿蘇,はい,350,325,281,226,184,156,94,1616,177,178,144,147,90,97,62,895
熊本県,4306,阿蘇,いいえ,556,626,589,746,848,1096,1234,5695,612,706,745,798,962,1211,1354,6388
熊本県,4308,八代,はい,774,829,597,528,350,189,132,3399,387,442,358,289,198,132,85,1891
熊本県,4308,八代,いいえ,1370,1540,1617,1615,1626,1546,1596,10910,1338,1611,1590,1672,1785,1818,1916,11730
熊本県,4309,芦北,はい,202,193,156,166,119,67,36,939,86,105,78,72,51,38,26,456
熊本県,4309,芦北,いいえ,368,448,556,565,552,548,512,3549,351,379,464,515,546,571,536,3362
熊本県,4310,球磨,はい,472,477,377,349,267,177,139,2258,261,294,236,167,133,115,84,1290
熊本県,4310,球磨,いいえ,861,1028,1041,1189,1420,1513,1745,8797,953,1083,1140,1287,1433,1637,2020,9553
熊本県,4311,天草,はい,540,492,489,361,278,170,122,2452,260,308,236,231,179,102,77,1393
熊本県,4311,天草,いいえ,974,1221,1227,1355,1661,1647,1681,9766,1103,1296,1431,1606,1704,1887,1894,10921
熊本県,4312,熊本・上益城,はい,5093,5244,4060,2974,1966,1136,714,21187,2546,2859,2333,1704,1163,720,599,11924
熊本県,4312,熊本・上益城,いいえ,8701,10525,9853,9838,9428,8369,8377,65091,9363,10947,10310,9739,8806,8537,9892,67594
大分県,4401,東部,はい,986,1078,917,686,530,357,291,4845,543,652,632,489,378,231,261,3186
大分県,4401,東部,いいえ,1583,1990,1948,1941,2257,2407,3040,15166,1836,2218,2332,2345,2488,2804,3835,17858
大分県,4403,中部,はい,3661,4118,3064,2112,1537,861,564,15917,1749,1963,1690,1173,867,517,491,8450
大分県,4403,中部,いいえ,6659,8159,7495,6843,7099,6615,7087,49957,6675,8037,7600,6756,6733,6775,8333,50909
大分県,4405,南部,はい,352,394,309,246,170,128,96,1695,187,187,190,116,105,81,77,943
大分県,4405,南部,いいえ,588,686,667,744,815,1006,1228,5734,579,670,744,782,960,1201,1573,6509
大分県,4406,豊肥,はい,242,261,225,179,159,81,85,1232,136,148,125,87,113,55,57,721
大分県,4406,豊肥,いいえ,451,505,527,554,849,928,1194,5008,512,564,588,654,925,1089,1332,5664
大分県,4408,西部,はい,518,493,411,373,267,178,105,2345,225,269,221,165,136,81,75,1172
大分県,4408,西部,いいえ,787,1041,984,1071,1287,1257,1372,7799,832,962,1007,1102,1226,1283,1567,7979
大分県,4409,北部,はい,1051,1060,815,632,411,254,157,4380,465,486,405,328,233,162,146,2225
大分県,4409,北部,いいえ,1856,2096,2006,1936,1995,1900,2188,13977,1391,1678,1778,1663,1909,2143,2647,13209
宮崎県,4501,宮崎東諸県,はい,2860,3092,2397,1556,1091,625,393,12014,1271,1524,1286,889,654,377,310,6311
宮崎県,4501,宮崎東諸県,いいえ,4856,5973,5598,5367,5081,4395,4531,35801,4758,5832,5370,4825,4319,4315,5241,34660
宮崎県,4502,都城北諸県,はい,1152,1076,817,566,473,249,253,4586,541,517,406,324,277,206,177,2448
宮崎県,4502,都城北諸県,いいえ,1900,2145,1894,1982,2411,2474,3117,15923,1719,2023,2001,2022,2425,3026,4004,17220
宮崎県,4503,延岡西臼杵,はい,954,1100,877,659,433,251,205,4479,409,496,419,274,219,154,132,2103
宮崎県,4503,延岡西臼杵,いいえ,1727,2048,2074,2000,2009,1941,2472,14271,1383,1715,1707,1732,1839,2173,2870,13419
宮崎県,4504,日南串間,はい,317,318,264,184,149,96,101,1429,132,138,119,110,66,53,73,691
宮崎県,4504,日南串間,いいえ,485,544,575,649,803,855,956,4867,451,507,530,651,757,944,1237,5077
宮崎県,4505,西諸,はい,317,305,230,208,200,140,119,1519,169,156,135,131,112,71,100,874
宮崎県,4505,西諸,いいえ,583,577,575,700,872,1017,1355,5679,543,578,569,748,901,1198,1516,6053
宮崎県,4506,西都児湯,はい,464,480,375,322,227,172,132,2172,222,276,208,159,141,105,88,1199
宮崎県,4506,西都児湯,いいえ,802,948,862,911,1088,1329,1538,7478,840,1005,985,1002,1144,1463,1871,8310
宮崎県,4507,日向入郷,はい,467,481,335,258,189,141,95,1966,219,251,176,126,81,62,63,978
宮崎県,4507,日向入郷,いいえ,810,960,856,921,927,1034,1253,6761,801,859,937,855,953,1092,1517,7014
鹿児島県,4601,鹿児島,はい,3897,4016,3089,2202,1584,999,704,16491,1765,1780,1402,1040,796,591,503,7877
鹿児島県,4601,鹿児島,いいえ,6742,8227,7742,7697,8051,7748,9000,55207,6638,7725,7575,6953,7117,8214,10537,54759
鹿児島県,4603,南薩,はい,467,481,401,337,305,256,196,2443,207,198,174,161,132,112,124,1108
鹿児島県,4603,南薩,いいえ,999,1062,1163,1359,1681,2176,2682,11122,887,1035,1123,1309,1766,2493,3175,11788
鹿児島県,4605,川薩,はい,656,621,500,468,337,241,192,3015,268,256,220,218,179,124,130,1395
鹿児島県,4605,川薩,いいえ,1152,1345,1296,1539,1699,1898,2468,11397,1098,1254,1368,1422,1658,2159,2728,11687
鹿児島県,4606,出水,はい,433,362,339,230,161,131,111,1767,201,184,174,139,101,98,72,969
鹿児島県,4606,出水,いいえ,717,850,868,984,1025,1139,1381,6964,716,853,891,943,1054,1364,1589,7410
鹿児島県,4607,姶良・伊佐,はい,1284,1237,1011,748,610,357,262,5509,591,521,470,363,309,224,208,2686
鹿児島県,4607,姶良・伊佐,いいえ,2426,2890,2932,3149,3202,3163,4061,21823,2243,2718,2832,2872,3054,3510,4695,21924
鹿児島県,4609,曽於,はい,348,280,276,209,203,144,96,1556,150,145,130,100,110,73,61,769
鹿児島県,4609,曽於,いいえ,601,662,693,823,1021,1051,1251,6102,540,571,641,800,980,1150,1355,6037
鹿児島県,4610,肝属,はい,826,681,512,409,377,274,199,3278,349,361,325,262,202,183,173,1855
鹿児島県,4610,肝属,いいえ,1320,1428,1457,1616,1889,2015,2330,12055,1163,1342,1422,1524,1895,2202,2654,12202
鹿児島県,4611,熊毛,はい,203,214,221,168,129,92,74,1101,102,94,87,76,70,56,43,528
鹿児島県,4611,熊毛,いいえ,326,408,404,450,493,547,597,3225,295,329,377,338,431,604,707,3081
鹿児島県,4612,奄美,はい,498,511,405,373,337,243,169,2536,311,340,264,205,191,142,119,1572
鹿児島県,4612,奄美,いいえ,811,958,988,1096,1175,1486,1558,8072,870,916,919,990,1259,1700,1841,8495
沖縄県,4701,北部,はい,627,616,445,371,363,289,222,2933,400,360,289,296,256,215,152,1968
沖縄県,4701,北部,いいえ,895,1046,879,913,1109,1297,1328,7467,868,960,774,900,1101,1191,1269,7063
沖縄県,4702,中部,はい,2793,2898,2272,1563,1045,636,413,11620,1859,2016,1744,1228,850,502,307,8506
沖縄県,4702,中部,いいえ,4161,5513,5055,4422,3741,2979,2679,28550,4356,5464,4886,4103,3497,3082,3061,28449
沖縄県,4703,南部,はい,4127,4462,3638,2400,1665,1196,869,18357,2755,3034,2661,1916,1285,975,702,13328
沖縄県,4703,南部,いいえ,6657,8167,7678,6923,6105,5437,5488,46455,7226,8305,8078,7041,6296,6321,6642,49909
沖縄県,4704,宮古,はい,345,361,250,234,207,192,92,1681,217,203,181,154,172,116,64,1107
沖縄県,4704,宮古,いいえ,375,449,427,506,552,597,542,3448,437,454,389,497,593,649,629,3648
沖縄県,4705,八重山,はい,187,188,151,94,103,111,81,915,139,126,117,88,88,70,50,678
沖縄県,4705,八重山,いいえ,229,292,292,243,282,312,359,2009,270,298,232,250,290,383,441,2164
二次医療圏判別不可,,,はい,19058,19959,17815,12231,4774,875,263,74975,7322,8149,7510,4791,2363,670,288,31093
二次医療圏判別不可,,,いいえ,57008,62634,64724,62496,33154,9649,5976,295641,33424,39286,38367,30354,16103,6821,4190,168545
