都道府県名,二次医療圏番号,二次医療圏名,回答,男40～44歳,男45～49歳,男50～54歳,男55～59歳,男60～64歳,男65～69歳,男70～74歳,男中計,女40～44歳,女45～49歳,女50～54歳,女55～59歳,女60～64歳,女65～69歳,女70～74歳,女中計
北海道,0101,南渡島,1,1341,1790,1648,1539,1513,1388,1741,10960,765,1054,1053,991,999,1199,1803,7864
北海道,0101,南渡島,2,1662,1937,1732,1556,1266,1061,940,10154,1491,1861,1822,1549,1313,1168,1221,10425
北海道,0101,南渡島,3,524,644,590,497,497,431,472,3655,547,694,717,603,620,569,705,4455
北海道,0101,南渡島,4,455,596,448,413,325,279,269,2785,393,522,490,435,397,395,445,3077
北海道,0101,南渡島,5,510,764,730,652,623,602,696,4577,303,460,520,556,524,663,940,3966
北海道,0102,南檜山,1,70,100,106,90,107,109,118,700,48,59,50,63,76,86,129,511
北海道,0102,南檜山,2,115,126,109,114,92,75,66,697,98,100,101,86,82,67,97,631
北海道,0102,南檜山,3,39,39,49,37,40,33,29,266,31,32,50,38,38,36,43,268
北海道,0102,南檜山,4,30,39,23,26,15,18,14,165,17,29,27,28,23,26,32,182
北海道,0102,南檜山,5,19,44,41,36,42,28,47,257,14,15,19,22,29,38,60,197
北海道,0103,北渡島檜山,1,144,124,151,138,144,145,156,1002,66,85,71,77,93,123,155,670
北海道,0103,北渡島檜山,2,121,153,138,121,99,83,74,789,92,112,98,118,94,93,111,718
北海道,0103,北渡島檜山,3,46,67,46,41,41,37,35,313,39,51,48,50,48,47,47,330
北海道,0103,北渡島檜山,4,39,54,40,45,32,32,27,269,27,47,45,29,27,29,27,231
北海道,0103,北渡島檜山,5,46,51,51,45,39,51,67,350,24,29,29,40,40,57,81,300
北海道,0104,札幌,1,10508,12899,12039,10723,9630,5983,3665,65447,6415,7639,7209,6047,4816,2853,2219,37198
北海道,0104,札幌,2,12650,14277,13435,10950,9009,5283,2882,68486,11454,13343,12042,9888,6634,3276,2035,58672
北海道,0104,札幌,3,5339,6061,5818,4986,4014,2448,1362,30028,5322,6075,5888,4723,3327,1881,1158,28374
北海道,0104,札幌,4,4413,5180,4552,3735,2955,1686,889,23410,3543,4305,4058,3336,2323,1238,760,19563
北海道,0104,札幌,5,4469,6264,6427,6222,5671,3506,2345,34904,2669,3719,4227,3961,3143,2036,1774,21529
北海道,0105,後志,1,802,1051,960,938,854,838,890,6333,393,620,562,586,537,641,920,4259
北海道,0105,後志,2,776,992,979,821,722,598,584,5472,642,873,858,714,665,546,663,4961
北海道,0105,後志,3,396,491,466,433,346,312,355,2799,372,450,430,400,334,382,468,2836
北海道,0105,後志,4,267,338,289,241,220,162,143,1660,212,254,260,232,204,191,188,1541
北海道,0105,後志,5,276,400,386,409,338,351,351,2511,146,226,223,267,295,311,474,1942
北海道,0106,南空知,1,532,781,668,732,744,654,621,4732,316,471,435,449,426,425,540,3062
北海道,0106,南空知,2,597,762,682,670,606,449,369,4135,481,654,671,658,537,416,468,3885
北海道,0106,南空知,3,274,341,330,294,320,275,227,2061,240,332,331,293,331,278,332,2137
北海道,0106,南空知,4,196,251,204,184,176,152,132,1295,172,213,225,175,203,166,162,1316
北海道,0106,南空知,5,155,302,262,295,304,352,388,2058,120,167,205,224,232,292,444,1684
北海道,0107,中空知,1,334,467,423,448,476,390,473,3011,210,307,276,309,322,326,468,2218
北海道,0107,中空知,2,358,517,489,469,407,358,371,2969,380,457,451,415,363,348,415,2829
北海道,0107,中空知,3,148,208,201,193,160,145,136,1191,172,229,211,191,162,188,203,1356
北海道,0107,中空知,4,97,161,141,122,115,89,102,827,98,132,123,132,112,149,168,914
北海道,0107,中空知,5,115,169,162,183,160,164,256,1209,73,86,99,148,148,212,371,1137
北海道,0108,北空知,1,86,109,92,128,142,129,184,870,67,66,70,75,86,101,185,650
北海道,0108,北空知,2,84,120,98,104,107,82,95,690,98,100,107,91,104,106,106,712
北海道,0108,北空知,3,48,72,78,81,71,73,64,487,57,81,76,79,74,74,71,512
北海道,0108,北空知,4,33,39,35,33,41,27,32,240,26,23,43,48,39,36,38,253
北海道,0108,北空知,5,25,40,49,55,42,63,67,341,21,32,40,36,28,68,115,340
北海道,0109,西胆振,1,614,858,767,703,699,623,836,5100,356,452,460,438,454,506,873,3539
北海道,0109,西胆振,2,767,1028,909,767,648,592,677,5388,641,843,796,718,624,580,799,5001
北海道,0109,西胆振,3,320,369,375,307,245,256,256,2128,287,365,392,326,270,322,350,2312
北海道,0109,西胆振,4,224,304,248,189,177,155,178,1475,169,239,222,198,175,207,242,1452
北海道,0109,西胆振,5,248,433,378,344,321,343,461,2528,131,214,234,217,235,342,539,1912
北海道,0110,東胆振,1,1043,1287,1074,978,850,838,955,7025,469,552,486,475,453,552,904,3891
北海道,0110,東胆振,2,1294,1538,1218,1013,783,712,688,7246,927,1083,993,883,699,768,818,6171
北海道,0110,東胆振,3,634,744,603,526,464,413,356,3740,471,600,490,439,427,401,484,3312
北海道,0110,東胆振,4,366,463,360,325,277,194,214,2199,271,307,275,245,193,234,307,1832
北海道,0110,東胆振,5,401,609,598,548,490,489,653,3788,183,296,313,312,312,499,697,2612
北海道,0111,日高,1,201,281,261,205,212,226,239,1625,126,149,135,132,163,179,186,1070
北海道,0111,日高,2,238,280,241,214,181,144,129,1427,178,230,226,195,144,158,161,1292
北海道,0111,日高,3,115,150,111,117,80,55,63,691,86,118,124,113,92,88,109,730
北海道,0111,日高,4,79,90,90,61,59,36,28,443,56,78,57,64,44,44,51,394
北海道,0111,日高,5,97,107,88,89,94,77,86,638,48,62,67,52,75,65,125,494
北海道,0112,上川中部,1,1206,1562,1388,1307,1245,850,640,8198,703,868,831,715,592,404,420,4533
北海道,0112,上川中部,2,1467,1712,1544,1331,1138,725,395,8312,1208,1456,1349,1088,761,400,317,6579
北海道,0112,上川中部,3,669,829,701,632,572,370,232,4005,593,738,741,575,444,269,235,3595
北海道,0112,上川中部,4,500,592,493,407,332,192,102,2618,414,472,495,335,269,145,128,2258
北海道,0112,上川中部,5,464,616,675,609,632,373,290,3659,250,388,418,414,359,290,264,2383
北海道,0113,上川北部,1,185,248,212,221,222,156,193,1437,129,114,139,126,137,135,186,966
北海道,0113,上川北部,2,209,255,267,227,194,146,124,1422,165,207,170,147,148,116,116,1069
北海道,0113,上川北部,3,92,137,120,123,106,82,51,711,86,107,98,103,86,79,97,656
北海道,0113,上川北部,4,86,93,72,71,64,45,45,476,52,64,46,55,61,51,54,383
北海道,0113,上川北部,5,63,96,100,115,112,84,95,665,36,56,44,64,72,89,120,481
北海道,0114,富良野,1,146,184,183,201,199,166,232,1311,87,134,136,122,106,174,239,998
北海道,0114,富良野,2,195,207,216,205,176,153,135,1287,205,218,239,201,194,151,216,1424
北海道,0114,富良野,3,69,94,78,108,78,72,76,575,85,103,88,83,107,76,98,640
北海道,0114,富良野,4,58,74,56,60,50,56,47,401,54,64,58,52,47,62,59,396
北海道,0114,富良野,5,56,71,78,81,105,108,151,650,30,50,57,77,79,104,182,579
北海道,0115,留萌,1,145,214,189,199,186,177,175,1285,77,92,108,126,127,134,194,858
北海道,0115,留萌,2,156,199,211,160,170,145,112,1153,136,193,176,159,157,155,159,1135
北海道,0115,留萌,3,81,104,111,97,78,68,64,603,79,98,96,76,81,68,79,577
北海道,0115,留萌,4,48,80,50,44,37,29,35,323,39,50,57,45,38,51,53,333
北海道,0115,留萌,5,51,78,86,80,83,59,74,511,24,46,46,41,66,69,137,429
北海道,0116,宗谷,1,279,387,335,349,332,294,254,2230,171,185,196,181,171,165,212,1281
北海道,0116,宗谷,2,278,342,299,259,263,178,150,1769,227,231,232,215,168,151,131,1355
北海道,0116,宗谷,3,133,153,130,128,96,103,71,814,110,111,102,83,86,78,81,651
北海道,0116,宗谷,4,87,109,88,74,47,40,37,482,65,93,68,75,54,48,53,456
北海道,0116,宗谷,5,105,148,130,130,106,107,96,822,55,74,51,57,75,87,126,525
北海道,0117,北網,1,826,1114,965,973,935,624,730,6167,466,593,548,585,567,521,736,4016
北海道,0117,北網,2,827,965,861,762,707,529,540,5191,709,893,758,729,652,613,790,5144
北海道,0117,北網,3,503,620,544,452,463,325,319,3226,423,503,474,464,404,355,347,2970
北海道,0117,北網,4,301,357,271,253,226,178,160,1746,235,273,271,274,223,198,248,1722
北海道,0117,北網,5,297,428,432,433,381,324,366,2661,180,271,282,290,285,314,478,2100
北海道,0118,遠紋,1,253,313,289,309,261,223,263,1911,120,138,136,150,182,181,254,1161
北海道,0118,遠紋,2,204,240,262,236,209,164,184,1499,160,211,221,211,170,176,230,1379
北海道,0118,遠紋,3,161,220,176,173,151,117,108,1106,126,136,177,160,142,135,143,1019
北海道,0118,遠紋,4,78,95,90,80,79,54,64,540,44,67,79,60,52,82,98,482
北海道,0118,遠紋,5,61,102,129,120,108,90,152,762,39,65,68,74,75,125,256,702
北海道,0119,十勝,1,1414,1674,1568,1550,1449,1269,1339,10263,756,932,951,875,924,929,1199,6566
北海道,0119,十勝,2,1438,1736,1515,1401,1261,969,876,9196,1245,1583,1449,1356,1131,1025,1088,8877
北海道,0119,十勝,3,741,939,912,770,715,565,564,5206,776,909,887,803,689,640,670,5374
北海道,0119,十勝,4,515,599,479,415,364,295,272,2939,376,486,458,403,303,309,397,2732
北海道,0119,十勝,5,483,687,634,658,659,626,828,4575,294,453,497,506,519,693,1056,4018
北海道,0120,釧路,1,886,1093,1129,1024,999,872,955,6958,460,609,622,579,597,727,967,4561
北海道,0120,釧路,2,1129,1436,1248,1109,1026,737,679,7364,955,1260,1130,947,876,719,755,6642
北海道,0120,釧路,3,501,557,512,446,437,376,364,3193,449,557,508,450,423,494,487,3368
北海道,0120,釧路,4,304,406,309,266,243,200,198,1926,233,271,282,276,219,200,214,1695
北海道,0120,釧路,5,277,403,435,403,390,409,505,2822,170,215,251,274,293,421,534,2158
北海道,0121,根室,1,309,351,299,314,291,227,228,2019,152,197,180,178,167,186,211,1271
北海道,0121,根室,2,308,353,338,264,234,170,148,1815,275,308,272,246,216,180,152,1649
北海道,0121,根室,3,142,169,117,118,111,74,65,796,143,116,131,111,97,94,78,770
北海道,0121,根室,4,104,96,87,69,68,53,39,516,77,90,86,75,72,49,39,488
北海道,0121,根室,5,84,139,101,134,83,111,120,772,57,62,77,75,99,118,152,640
青森県,0201,津軽地域,1,1329,1621,1555,1566,1465,1119,1134,9789,851,1048,1027,1222,1012,893,1079,7132
青森県,0201,津軽地域,2,1362,1320,1274,1146,1061,646,475,7284,1325,1441,1390,1356,1093,755,580,7940
青森県,0201,津軽地域,3,325,364,311,318,258,173,115,1864,341,395,386,351,232,190,147,2042
青森県,0201,津軽地域,4,396,394,328,310,226,130,89,1873,349,372,333,313,223,150,150,1890
青森県,0201,津軽地域,5,425,536,503,449,408,328,290,2939,193,305,344,319,283,269,288,2001
青森県,0202,八戸地域,1,1558,1961,2010,1821,1854,1528,1617,12349,821,963,1048,969,977,1032,1236,7046
青森県,0202,八戸地域,2,1980,2244,2353,1972,1794,1246,986,12575,1818,2271,2280,1954,1639,1348,1266,12576
青森県,0202,八戸地域,3,644,692,655,626,617,441,378,4053,592,744,750,686,649,598,596,4615
青森県,0202,八戸地域,4,848,988,829,718,531,423,355,4692,667,880,760,662,622,485,451,4527
青森県,0202,八戸地域,5,839,1194,1201,1125,1088,1039,1079,7565,448,688,801,780,798,962,1275,5752
青森県,0203,青森地域,1,1713,2235,2192,2215,2202,1675,1988,14220,1144,1393,1338,1473,1361,1438,2245,10392
青森県,0203,青森地域,2,1826,2040,1851,1691,1527,1078,993,11006,1796,2172,1923,1656,1464,1227,1370,11608
青森県,0203,青森地域,3,649,746,694,690,599,531,613,4522,698,792,720,749,778,726,938,5401
青森県,0203,青森地域,4,582,665,578,471,372,241,199,3108,463,574,479,422,362,304,274,2878
青森県,0203,青森地域,5,570,843,773,723,697,603,734,4943,295,442,507,514,469,616,776,3619
青森県,0204,西北五地域,1,464,581,625,701,642,819,937,4769,302,373,459,525,632,857,1117,4265
青森県,0204,西北五地域,2,434,519,494,512,443,386,349,3137,457,553,609,582,644,621,545,4011
青森県,0204,西北五地域,3,120,178,166,161,122,113,68,928,145,163,204,188,156,125,140,1121
青森県,0204,西北五地域,4,116,137,121,107,67,61,74,683,139,157,119,147,134,134,114,944
青森県,0204,西北五地域,5,136,178,182,186,166,139,226,1213,53,90,115,138,145,218,257,1016
青森県,0205,上十三地域,1,848,991,982,924,955,985,1163,6848,445,587,603,588,665,808,1147,4843
青森県,0205,上十三地域,2,1019,1128,1047,900,856,632,577,6159,900,1088,1025,868,841,755,719,6196
青森県,0205,上十三地域,3,290,328,293,272,258,200,160,1801,308,371,333,316,333,285,236,2182
青森県,0205,上十三地域,4,395,435,344,312,270,179,148,2083,307,347,347,283,254,240,216,1994
青森県,0205,上十三地域,5,420,527,490,450,442,386,356,3071,190,263,273,323,303,368,435,2155
青森県,0206,下北地域,1,240,344,351,339,353,404,457,2488,136,212,244,228,292,369,468,1949
青森県,0206,下北地域,2,336,358,331,346,357,241,187,2156,342,417,408,332,323,255,232,2309
青森県,0206,下北地域,3,102,131,111,100,104,67,71,686,113,134,112,117,95,89,82,742
青森県,0206,下北地域,4,118,126,107,94,80,73,53,651,86,120,105,78,95,95,74,653
青森県,0206,下北地域,5,115,140,127,148,133,135,140,938,66,74,86,96,109,151,157,739
岩手県,0301,盛岡,1,2329,2671,2687,2485,2601,2156,2614,17543,1420,1688,1520,1470,1608,1889,2584,12179
岩手県,0301,盛岡,2,3374,3751,3343,2899,2506,2054,1931,19858,3176,3652,3341,2887,2522,2278,2404,20260
岩手県,0301,盛岡,3,1683,1815,1576,1448,1326,1073,992,9913,1438,1728,1600,1372,1351,1396,1554,10439
岩手県,0301,盛岡,4,987,1193,1048,848,732,526,507,5841,807,930,926,807,719,671,731,5591
岩手県,0301,盛岡,5,1160,1622,1611,1476,1424,1218,1537,10048,547,839,935,996,1057,1274,1810,7458
岩手県,0302,岩手中部,1,1150,1364,1271,1263,1248,1235,1335,8866,629,801,757,733,758,917,1257,5852
岩手県,0302,岩手中部,2,1576,1683,1392,1278,1116,942,861,8848,1335,1508,1355,1200,1062,1040,1003,8503
岩手県,0302,岩手中部,3,797,803,694,603,553,541,551,4542,667,748,661,657,599,736,811,4879
岩手県,0302,岩手中部,4,447,480,375,349,309,243,221,2424,303,399,348,315,316,277,332,2290
岩手県,0302,岩手中部,5,535,673,622,573,530,537,664,4134,242,335,421,422,507,649,895,3471
岩手県,0303,胆江,1,722,808,631,766,793,863,965,5548,362,410,386,441,516,637,886,3638
岩手県,0303,胆江,2,973,997,885,722,752,751,717,5797,832,969,811,760,806,850,969,5997
岩手県,0303,胆江,3,463,514,403,335,359,316,251,2641,402,416,368,347,359,346,363,2601
岩手県,0303,胆江,4,221,274,221,185,200,157,150,1408,181,215,200,225,190,206,204,1421
岩手県,0303,胆江,5,240,408,358,330,360,333,399,2428,154,199,217,219,290,401,534,2014
岩手県,0304,両磐,1,630,644,647,701,775,757,774,4928,305,365,380,391,448,540,580,3009
岩手県,0304,両磐,2,735,851,711,690,654,576,578,4795,693,736,706,690,665,616,588,4694
岩手県,0304,両磐,3,366,399,322,343,337,392,362,2521,300,386,340,356,387,505,517,2791
岩手県,0304,両磐,4,195,212,181,167,160,115,97,1127,149,186,190,163,167,129,135,1119
岩手県,0304,両磐,5,221,302,300,278,274,250,378,2003,115,162,151,214,249,298,420,1609
岩手県,0305,気仙,1,198,291,344,314,354,353,427,2281,128,173,170,190,215,279,354,1509
岩手県,0305,気仙,2,302,370,327,346,266,236,227,2074,276,362,336,345,266,286,286,2157
岩手県,0305,気仙,3,161,222,210,208,155,131,132,1219,153,157,220,197,182,221,207,1337
岩手県,0305,気仙,4,79,112,123,113,72,74,57,630,55,99,103,122,117,115,124,735
岩手県,0305,気仙,5,89,129,149,175,147,143,184,1016,64,84,95,126,128,176,284,957
岩手県,0306,釜石,1,156,210,211,221,219,246,293,1556,96,121,129,115,152,171,276,1060
岩手県,0306,釜石,2,222,259,257,254,169,142,119,1422,191,219,190,201,164,146,167,1278
岩手県,0306,釜石,3,114,153,126,111,117,87,80,788,104,105,110,110,116,111,112,768
岩手県,0306,釜石,4,58,66,66,65,57,54,33,399,48,65,73,52,68,57,75,438
岩手県,0306,釜石,5,82,87,119,96,80,105,109,678,27,50,61,87,81,125,194,625
岩手県,0307,宮古,1,320,393,444,467,464,529,670,3287,142,186,241,209,269,386,579,2012
岩手県,0307,宮古,2,366,354,431,367,292,261,257,2328,322,379,375,340,336,336,323,2411
岩手県,0307,宮古,3,196,211,261,238,197,155,171,1429,188,204,220,211,228,214,243,1508
岩手県,0307,宮古,4,104,124,109,111,75,58,77,658,69,112,121,96,120,110,159,787
岩手県,0307,宮古,5,118,156,184,185,154,180,284,1261,73,125,116,126,167,256,384,1247
岩手県,0308,久慈,1,222,276,314,279,358,363,434,2246,147,163,169,175,252,249,356,1511
岩手県,0308,久慈,2,297,326,349,300,323,228,233,2056,261,327,362,307,286,296,251,2090
岩手県,0308,久慈,3,117,158,170,141,174,132,137,1029,134,147,180,158,182,191,190,1182
岩手県,0308,久慈,4,102,96,73,75,71,50,60,527,72,88,106,65,86,116,112,645
岩手県,0308,久慈,5,105,161,142,133,135,153,202,1031,67,91,113,109,141,202,299,1022
岩手県,0309,二戸,1,236,314,300,334,379,433,532,2528,143,187,208,187,267,327,441,1760
岩手県,0309,二戸,2,266,288,332,338,287,266,214,1991,281,282,379,318,292,290,269,2111
岩手県,0309,二戸,3,126,142,154,139,127,149,127,964,132,170,172,179,179,207,195,1234
岩手県,0309,二戸,4,75,100,85,81,78,76,70,565,66,84,101,94,102,106,114,667
岩手県,0309,二戸,5,115,120,132,156,164,179,185,1051,72,66,91,104,142,225,299,999
宮城県,0401,仙南,1,979,969,920,887,1000,1109,1302,7166,517,569,550,559,643,756,946,4540
宮城県,0401,仙南,2,1092,1168,991,915,928,942,862,6898,972,1199,1035,1085,961,1026,933,7211
宮城県,0401,仙南,3,384,411,392,336,334,387,363,2607,407,457,396,380,420,484,482,3026
宮城県,0401,仙南,4,354,403,306,261,291,250,223,2088,232,330,304,265,306,298,244,1979
宮城県,0401,仙南,5,335,502,467,473,444,533,700,3454,187,254,285,318,443,614,850,2951
宮城県,0403,仙台,1,8524,9931,8889,7530,6929,6323,7458,55584,5285,6078,5315,4581,4474,4845,7090,37668
宮城県,0403,仙台,2,11376,12710,11754,9164,7427,5843,5584,63858,11086,12705,11197,8865,7663,6784,7004,65304
宮城県,0403,仙台,3,4284,4955,4275,3582,3015,2473,2575,25159,4636,5222,4691,3882,3413,3201,3741,28786
宮城県,0403,仙台,4,4144,4737,3991,3119,2455,1888,1805,22139,3067,3675,3498,2841,2363,2234,2366,20044
宮城県,0403,仙台,5,4415,6257,6291,5470,4819,4725,5726,37703,2478,3550,3894,3708,3688,4621,6626,28565
宮城県,0406,大崎・栗原,1,1744,1781,1466,1487,1842,1882,2071,12273,905,991,928,974,1156,1369,1533,7856
宮城県,0406,大崎・栗原,2,1726,1758,1497,1537,1500,1270,1065,10353,1580,1792,1604,1517,1538,1348,1147,10526
宮城県,0406,大崎・栗原,3,658,664,589,573,576,519,460,4039,659,754,637,610,710,731,601,4702
宮城県,0406,大崎・栗原,4,577,573,476,429,424,351,318,3148,424,471,453,445,403,459,391,3046
宮城県,0406,大崎・栗原,5,563,733,683,737,687,878,1003,5284,303,377,440,512,635,958,1284,4509
宮城県,0409,石巻・登米・気仙沼,1,1907,2138,1996,1952,2188,2243,2691,15115,1010,1171,1111,1236,1460,1564,2198,9750
宮城県,0409,石巻・登米・気仙沼,2,1974,2144,2025,1917,1765,1728,1735,13288,1852,2143,2031,2063,2057,2134,2052,14332
宮城県,0409,石巻・登米・気仙沼,3,727,804,803,679,685,700,722,5120,772,908,917,874,929,992,1016,6408
宮城県,0409,石巻・登米・気仙沼,4,654,721,561,521,449,433,406,3745,502,565,571,583,539,576,617,3953
宮城県,0409,石巻・登米・気仙沼,5,657,808,782,821,817,861,1158,5904,320,425,535,633,678,955,1450,4996
秋田県,0501,大館・鹿角,1,300,346,366,428,461,408,504,2813,198,215,233,255,282,311,493,1987
秋田県,0501,大館・鹿角,2,477,521,500,478,469,440,430,3315,440,526,487,481,513,523,597,3567
秋田県,0501,大館・鹿角,3,192,204,163,188,165,160,161,1233,188,161,160,161,182,206,250,1308
秋田県,0501,大館・鹿角,4,131,159,112,124,116,93,102,837,111,113,124,112,101,135,139,835
秋田県,0501,大館・鹿角,5,108,176,161,147,180,185,298,1255,71,89,106,116,154,236,374,1146
秋田県,0502,北秋田,1,78,111,104,121,132,168,232,946,37,67,58,75,95,144,220,696
秋田県,0502,北秋田,2,113,143,134,165,134,158,134,981,111,131,127,122,145,158,163,957
秋田県,0502,北秋田,3,34,33,34,41,39,49,51,281,40,33,37,43,53,75,76,357
秋田県,0502,北秋田,4,40,53,34,37,26,32,38,260,21,21,28,32,25,32,45,204
秋田県,0502,北秋田,5,33,42,44,52,46,54,68,339,-,-,30,21,38,66,101,281
秋田県,0503,能代・山本,1,292,313,338,383,395,426,500,2647,167,252,243,240,264,347,477,1990
秋田県,0503,能代・山本,2,401,426,445,395,449,389,343,2848,422,438,502,479,523,494,506,3364
秋田県,0503,能代・山本,3,109,152,146,137,131,126,116,917,128,159,161,147,163,184,225,1167
秋田県,0503,能代・山本,4,101,106,97,100,97,74,63,638,76,100,120,119,87,84,93,679
秋田県,0503,能代・山本,5,98,187,152,156,142,142,197,1074,47,73,100,120,159,177,236,912
秋田県,0504,秋田周辺,1,1145,1444,1294,1382,1369,1259,1588,9481,730,882,821,802,862,1090,1754,6941
秋田県,0504,秋田周辺,2,1994,2347,2158,1928,1689,1471,1491,13078,1913,2202,2140,1839,1791,1833,2025,13743
秋田県,0504,秋田周辺,3,673,802,699,655,643,521,579,4572,707,790,827,697,669,748,848,5286
秋田県,0504,秋田周辺,4,636,731,658,605,476,340,372,3818,481,524,527,422,435,473,543,3405
秋田県,0504,秋田周辺,5,649,899,982,953,888,814,1032,6217,317,473,499,552,698,964,1418,4921
秋田県,0505,由利本荘・にかほ,1,338,359,348,397,404,466,501,2813,199,229,226,288,328,417,499,2186
秋田県,0505,由利本荘・にかほ,2,539,553,518,514,480,539,504,3647,518,605,587,565,541,638,584,4038
秋田県,0505,由利本荘・にかほ,3,160,169,153,153,164,155,158,1112,183,178,194,152,167,213,188,1275
秋田県,0505,由利本荘・にかほ,4,141,117,172,102,104,106,96,838,106,107,150,111,145,145,114,878
秋田県,0505,由利本荘・にかほ,5,143,209,179,199,228,219,312,1489,72,107,112,148,180,254,319,1192
秋田県,0506,大仙・仙北,1,274,337,347,365,493,630,888,3334,202,216,192,279,404,634,819,2746
秋田県,0506,大仙・仙北,2,561,577,562,554,593,534,621,4002,582,601,626,575,657,764,696,4501
秋田県,0506,大仙・仙北,3,196,212,176,187,206,230,231,1438,178,211,176,182,255,315,310,1627
秋田県,0506,大仙・仙北,4,173,169,154,131,113,109,114,963,108,100,125,147,142,193,156,971
秋田県,0506,大仙・仙北,5,146,201,184,196,188,231,256,1402,70,98,128,137,199,334,494,1460
秋田県,0507,横手,1,308,316,333,410,447,499,674,2987,204,258,276,279,338,475,609,2439
秋田県,0507,横手,2,545,560,494,490,515,480,475,3559,559,606,579,563,602,620,576,4105
秋田県,0507,横手,3,162,193,148,155,136,143,157,1094,171,191,181,175,188,260,196,1362
秋田県,0507,横手,4,129,149,147,97,104,95,73,794,107,142,148,109,129,151,113,899
秋田県,0507,横手,5,154,177,151,166,168,169,202,1187,59,92,108,144,137,213,285,1038
秋田県,0508,湯沢・雄勝,1,191,210,229,263,319,441,527,2180,111,128,176,166,245,346,422,1594
秋田県,0508,湯沢・雄勝,2,319,327,354,332,357,344,300,2333,284,335,339,331,364,370,366,2389
秋田県,0508,湯沢・雄勝,3,97,92,82,110,110,89,123,703,68,108,114,118,118,159,157,842
秋田県,0508,湯沢・雄勝,4,82,71,77,73,70,63,56,492,45,56,70,64,68,92,88,483
秋田県,0508,湯沢・雄勝,5,65,104,109,123,123,139,152,815,-,-,61,72,107,167,211,696
山形県,0601,村山,1,3314,3515,3175,3090,3203,3450,4059,23806,2214,2338,2149,2056,2302,2444,2933,16436
山形県,0601,村山,2,4204,4165,3817,3382,3183,2725,2367,23843,4273,4571,4069,3765,3521,3087,2559,25845
山形県,0601,村山,3,1596,1634,1439,1279,1238,936,745,8867,1567,1721,1485,1404,1316,1116,926,9535
山形県,0601,村山,4,1235,1420,1161,997,892,700,634,7039,1018,1133,1133,1040,956,910,822,7012
山形県,0601,村山,5,1224,1639,1648,1656,1676,1699,2069,11611,627,883,982,1175,1393,1827,2236,9123
山形県,0602,最上,1,472,556,496,551,639,703,805,4222,344,403,400,443,510,558,571,3229
山形県,0602,最上,2,481,482,417,482,511,447,351,3171,466,522,536,502,554,520,428,3528
山形県,0602,最上,3,163,200,150,158,152,129,99,1051,151,179,159,164,192,145,106,1096
山形県,0602,最上,4,138,138,121,114,126,108,70,815,126,122,150,151,137,119,84,889
山形県,0602,最上,5,134,171,188,192,225,221,282,1413,62,102,115,143,239,322,361,1344
山形県,0603,置賜,1,1452,1646,1552,1459,1577,1588,1757,11031,1001,1115,1059,1076,1179,1224,1327,7981
山形県,0603,置賜,2,1507,1597,1495,1412,1270,1085,952,9318,1542,1645,1528,1448,1311,1181,910,9565
山形県,0603,置賜,3,585,561,541,456,454,402,283,3282,477,575,538,499,449,407,378,3323
山形県,0603,置賜,4,473,526,418,395,350,231,222,2615,383,418,436,393,390,336,307,2663
山形県,0603,置賜,5,453,623,610,650,632,689,795,4452,203,308,392,482,520,736,947,3588
山形県,0604,庄内,1,1694,2054,1974,2048,2316,2405,2727,15218,1193,1406,1397,1476,1702,1937,2445,11556
山形県,0604,庄内,2,2075,2085,1948,1725,1724,1464,1366,12387,2086,2275,2209,2039,2001,1763,1613,13986
山形県,0604,庄内,3,698,744,611,657,559,495,414,4178,697,776,695,704,634,605,585,4696
山形県,0604,庄内,4,556,632,551,455,409,331,293,3227,492,574,565,540,498,499,427,3595
山形県,0604,庄内,5,600,779,802,750,772,852,982,5537,333,473,500,569,705,1051,1298,4929
福島県,0701,県北,1,2285,2794,2651,2541,2499,2522,3023,18315,1344,1668,1622,1527,1565,1750,2291,11767
福島県,0701,県北,2,3282,3659,3307,3131,2840,2260,2284,20763,3238,3702,3583,3231,3005,2696,2707,22162
福島県,0701,県北,3,1403,1534,1395,1218,1252,1015,1059,8876,1387,1501,1546,1356,1374,1437,1483,10084
福島県,0701,県北,4,942,1046,990,823,732,601,545,5679,721,901,804,749,756,716,768,5415
福島県,0701,県北,5,1004,1394,1362,1372,1336,1436,1799,9703,504,740,811,916,1057,1489,2033,7550
福島県,0702,県中,1,2236,2524,2384,2321,2335,2207,2324,16331,1306,1604,1340,1425,1579,1536,2009,10799
福島県,0702,県中,2,3672,3928,3330,3015,2921,2158,1932,20956,3499,3905,3557,3245,2884,2415,2329,21834
福島県,0702,県中,3,1492,1663,1305,1220,1114,1035,955,8784,1489,1588,1495,1420,1432,1334,1356,10114
福島県,0702,県中,4,1006,1102,935,758,670,526,489,5486,758,873,802,794,686,662,689,5264
福島県,0702,県中,5,1022,1424,1375,1256,1242,1224,1683,9226,536,662,804,844,1032,1462,1971,7311
福島県,0703,県南,1,840,1012,828,912,948,934,959,6433,471,572,456,466,529,612,742,3848
福島県,0703,県南,2,1083,1023,925,920,753,623,559,5886,933,1060,905,833,943,749,640,6063
福島県,0703,県南,3,382,411,339,331,324,333,321,2441,438,402,388,386,439,457,432,2942
福島県,0703,県南,4,325,313,253,239,208,188,161,1687,230,233,214,203,222,232,225,1559
福島県,0703,県南,5,297,384,371,357,403,492,617,2921,134,197,212,252,379,535,700,2409
福島県,0706,相双,1,607,691,611,612,723,936,1243,5423,363,356,407,394,568,736,972,3796
福島県,0706,相双,2,745,866,706,736,791,800,695,5339,664,784,740,729,889,918,929,5653
福島県,0706,相双,3,298,332,307,318,379,405,419,2458,312,375,354,343,460,566,650,3060
福島県,0706,相双,4,257,274,234,211,202,204,199,1581,186,215,187,246,251,285,283,1653
福島県,0706,相双,5,237,333,310,286,332,532,738,2768,114,176,205,259,383,607,718,2462
福島県,0707,いわき,1,1527,1774,1684,1563,1462,1298,1436,10744,835,1033,931,838,910,864,1229,6640
福島県,0707,いわき,2,1994,2379,2172,1936,1631,1220,1089,12421,1811,2158,2009,1826,1645,1349,1263,12061
福島県,0707,いわき,3,863,992,891,754,694,536,465,5195,838,939,911,821,768,596,586,5459
福島県,0707,いわき,4,590,675,656,497,431,346,256,3451,452,523,512,502,442,351,350,3132
福島県,0707,いわき,5,648,893,893,830,752,775,882,5673,289,440,494,561,599,707,944,4034
福島県,0708,会津・南会津,1,1147,1338,1258,1370,1483,1444,1639,9679,742,886,900,970,1062,1160,1382,7102
福島県,0708,会津・南会津,2,1704,1701,1577,1619,1519,1425,1383,10928,1522,1766,1650,1702,1643,1602,1587,11472
福島県,0708,会津・南会津,3,641,675,623,625,660,588,591,4403,647,725,731,713,761,824,791,5192
福島県,0708,会津・南会津,4,472,558,468,435,441,361,346,3081,413,434,412,413,461,462,469,3064
福島県,0708,会津・南会津,5,480,686,635,734,735,822,1009,5101,249,376,446,540,607,928,1162,4308
茨城県,0801,水戸,1,2210,2814,2575,2155,1864,1340,1175,14133,1198,1402,1372,1199,970,887,846,7874
茨城県,0801,水戸,2,2991,3385,3119,2511,1967,1384,1056,16413,2652,3221,2896,2364,1969,1520,1322,15944
茨城県,0801,水戸,3,1109,1211,1165,946,784,539,434,6188,994,1211,1220,983,775,671,696,6550
茨城県,0801,水戸,4,969,1063,908,726,558,322,278,4824,712,814,791,662,446,381,351,4157
茨城県,0801,水戸,5,1019,1508,1600,1445,1156,911,833,8472,525,688,838,891,745,630,720,5037
茨城県,0802,日立,1,1277,1839,1868,1539,1348,1094,1254,10219,559,782,872,667,676,707,936,5199
茨城県,0802,日立,2,1441,1709,1758,1481,1140,848,799,9176,1160,1542,1489,1235,993,855,899,8173
茨城県,0802,日立,3,558,740,765,671,541,435,432,4142,510,719,851,622,544,473,438,4157
茨城県,0802,日立,4,589,728,721,552,495,344,347,3776,438,552,594,513,405,404,418,3324
茨城県,0802,日立,5,573,829,1084,992,833,859,1015,6185,259,410,548,564,576,681,1024,4062
茨城県,0803,常陸太田・ひたちなか,1,1779,2258,2328,2132,1686,1567,1720,13470,798,1075,1078,913,942,1059,1344,7209
茨城県,0803,常陸太田・ひたちなか,2,2311,2642,2696,2230,1798,1419,1293,14389,2002,2427,2392,1962,1792,1663,1727,13965
茨城県,0803,常陸太田・ひたちなか,3,864,1027,1041,865,740,583,608,5728,791,982,1059,871,797,799,808,6107
茨城県,0803,常陸太田・ひたちなか,4,762,878,817,669,526,391,393,4436,518,566,672,593,497,495,518,3859
茨城県,0803,常陸太田・ひたちなか,5,774,1173,1290,1197,1010,909,1090,7443,402,523,714,670,647,818,1048,4822
茨城県,0804,鹿行,1,1405,1725,1420,1219,1148,937,893,8747,570,718,706,608,578,560,689,4429
茨城県,0804,鹿行,2,1563,1823,1602,1278,1023,735,614,8638,1373,1620,1461,1203,1049,916,866,8488
茨城県,0804,鹿行,3,626,694,653,497,382,351,257,3460,569,579,624,490,474,402,383,3521
茨城県,0804,鹿行,4,520,598,546,386,271,230,189,2740,356,430,450,342,284,232,220,2314
茨城県,0804,鹿行,5,531,742,739,625,458,439,416,3950,286,371,404,368,363,338,440,2570
茨城県,0805,土浦,1,1267,1588,1388,1271,980,958,1066,8518,566,737,732,617,624,617,854,4747
茨城県,0805,土浦,2,1624,1940,1882,1416,1075,988,857,9782,1350,1760,1621,1334,1211,1110,1294,9680
茨城県,0805,土浦,3,661,715,669,547,461,398,350,3801,555,724,723,590,545,501,533,4171
茨城県,0805,土浦,4,505,549,527,430,330,255,240,2836,380,451,415,349,307,295,306,2503
茨城県,0805,土浦,5,534,821,849,799,669,623,757,5052,252,416,470,494,440,522,694,3288
茨城県,0806,つくば,1,1707,1902,1643,1324,1098,953,1152,9779,943,1112,860,753,684,679,986,6017
茨城県,0806,つくば,2,2707,2725,2341,1697,1355,1023,1063,12911,2353,2595,2199,1659,1335,1276,1239,12656
茨城県,0806,つくば,3,1086,1155,961,826,565,455,452,5500,1048,1221,987,766,616,584,614,5836
茨城県,0806,つくば,4,989,996,772,531,404,317,320,4329,677,710,654,469,391,359,404,3664
茨城県,0806,つくば,5,1045,1307,1236,1068,836,697,820,7009,547,681,737,629,553,646,797,4590
茨城県,0807,取手・竜ヶ崎,1,2145,2796,2557,2143,1770,1645,2189,15245,1212,1546,1414,1208,1091,1310,1939,9720
茨城県,0807,取手・竜ヶ崎,2,2667,3249,2907,2242,1684,1438,1392,15579,2396,2879,2662,2183,1813,1601,1667,15201
茨城県,0807,取手・竜ヶ崎,3,1308,1587,1495,1170,911,833,936,8240,1213,1540,1471,1184,1089,1172,1408,9077
茨城県,0807,取手・竜ヶ崎,4,972,1119,1018,802,641,510,501,5563,678,895,800,642,603,619,608,4845
茨城県,0807,取手・竜ヶ崎,5,1060,1567,1581,1414,1246,1286,1815,9969,537,724,867,894,907,1102,1565,6596
茨城県,0808,筑西・下妻,1,1171,1507,1398,1207,1144,1067,1038,8532,659,750,706,681,736,706,841,5079
茨城県,0808,筑西・下妻,2,1595,1794,1527,1290,1196,1128,953,9483,1365,1682,1654,1438,1261,1457,1238,10095
茨城県,0808,筑西・下妻,3,607,660,646,525,457,426,372,3693,548,676,674,603,551,584,485,4121
茨城県,0808,筑西・下妻,4,454,478,413,365,302,301,232,2545,331,425,399,323,360,341,335,2514
茨城県,0808,筑西・下妻,5,488,687,641,554,561,555,573,4059,207,337,403,368,414,446,532,2707
茨城県,0809,古河・坂東,1,1071,1221,1181,1030,918,645,541,6607,492,622,612,510,448,398,420,3502
茨城県,0809,古河・坂東,2,1342,1574,1421,1092,981,650,488,7548,1100,1378,1305,1019,902,720,558,6982
茨城県,0809,古河・坂東,3,559,572,615,470,389,236,227,3068,448,582,576,446,381,311,285,3029
茨城県,0809,古河・坂東,4,382,411,386,285,252,151,100,1967,238,334,304,243,243,179,139,1680
茨城県,0809,古河・坂東,5,396,558,608,514,422,384,303,3185,192,276,339,312,328,292,296,2035
栃木県,0901,県北,1,2079,2411,2204,1930,2040,1850,2075,14589,993,1241,1114,988,1127,1154,1325,7942
栃木県,0901,県北,2,2612,2788,2533,2031,1825,1714,1477,14980,2218,2505,2322,2029,1943,1863,1687,14567
栃木県,0901,県北,3,1316,1325,1121,1052,996,1065,1139,8014,1115,1322,1218,1124,1216,1521,1656,9172
栃木県,0901,県北,4,737,796,650,474,459,386,408,3910,512,581,584,471,487,468,477,3580
栃木県,0901,県北,5,907,1158,1151,1077,991,1195,1485,7964,426,591,714,724,820,1137,1585,5997
栃木県,0902,県西,1,830,1093,1087,884,936,847,986,6663,437,620,554,496,526,573,845,4051
栃木県,0902,県西,2,1006,1217,1163,1006,938,783,769,6882,906,1159,1082,988,953,887,948,6923
栃木県,0902,県西,3,493,602,525,490,425,411,375,3321,456,522,559,494,493,482,522,3528
栃木県,0902,県西,4,274,348,308,260,226,178,198,1792,231,273,289,279,225,258,278,1833
栃木県,0902,県西,5,359,512,570,511,502,530,591,3575,168,260,358,321,350,521,604,2582
栃木県,0903,宇都宮,1,3077,3635,3313,2717,2215,1588,1745,18290,1624,1846,1719,1355,1098,989,1506,10137
栃木県,0903,宇都宮,2,4043,4207,3838,2944,2132,1388,1260,19812,3320,3707,3356,2510,1974,1625,1641,18133
栃木県,0903,宇都宮,3,1968,2183,1991,1506,1095,736,651,10130,1736,2063,1781,1313,1081,869,902,9745
栃木県,0903,宇都宮,4,1389,1463,1318,976,702,422,423,6693,902,1027,1024,821,593,545,513,5425
栃木県,0903,宇都宮,5,1736,2377,2383,2129,1654,1330,1430,13039,798,1141,1251,1199,1033,1135,1531,8088
栃木県,0904,県東,1,871,1005,872,760,824,804,731,5867,369,474,374,380,435,419,486,2937
栃木県,0904,県東,2,1090,1112,927,844,713,641,599,5926,850,962,863,723,735,700,656,5489
栃木県,0904,県東,3,564,599,495,439,442,585,682,3806,475,581,537,495,655,882,934,4559
栃木県,0904,県東,4,298,351,253,255,241,163,155,1716,192,225,253,208,192,196,173,1439
栃木県,0904,県東,5,407,541,541,464,426,525,630,3534,191,244,272,293,352,508,635,2495
栃木県,0905,県南,1,2448,3172,2822,2281,2202,1851,1874,16650,1205,1454,1454,1155,1147,1164,1437,9016
栃木県,0905,県南,2,3129,3656,3235,2528,2180,1845,1554,18127,2843,3347,3033,2445,2149,1934,1743,17494
栃木県,0905,県南,3,1394,1750,1527,1322,1176,1292,1411,9872,1363,1615,1629,1344,1470,1729,1969,11119
栃木県,0905,県南,4,951,1150,905,757,587,452,426,5228,621,765,816,618,579,543,501,4443
栃木県,0905,県南,5,1071,1626,1555,1520,1387,1348,1723,10230,529,726,957,928,1012,1240,1713,7105
栃木県,0906,両毛,1,1151,1505,1506,1288,1048,1039,1170,8707,575,766,712,635,616,704,1050,5058
栃木県,0906,両毛,2,1633,1800,1731,1440,1205,814,748,9371,1250,1509,1534,1266,1115,926,867,8467
栃木県,0906,両毛,3,727,878,800,681,546,438,414,4484,501,676,733,629,507,574,587,4207
栃木県,0906,両毛,4,452,584,521,400,324,264,309,2854,347,442,402,361,336,316,384,2588
栃木県,0906,両毛,5,559,807,815,739,642,691,946,5199,239,413,453,491,501,786,1213,4096
群馬県,1001,前橋,1,1700,2209,2051,1788,1632,1511,1708,12599,1011,1312,1278,1072,960,978,1548,8159
群馬県,1001,前橋,2,2183,2532,2363,1930,1602,1282,1309,13201,1911,2401,2258,2015,1735,1646,1881,13847
群馬県,1001,前橋,3,970,1087,979,827,624,535,525,5547,788,1007,938,803,665,693,721,5615
群馬県,1001,前橋,4,758,824,747,597,472,446,412,4256,468,609,658,581,511,557,592,3976
群馬県,1001,前橋,5,842,1095,1195,1016,976,918,1161,7203,359,561,722,743,705,998,1265,5353
群馬県,1002,渋川,1,570,675,634,575,658,594,703,4409,293,381,386,311,328,392,557,2648
群馬県,1002,渋川,2,685,777,650,605,546,456,435,4154,596,692,678,576,527,504,528,4101
群馬県,1002,渋川,3,277,298,292,212,230,188,167,1664,255,279,276,256,256,237,235,1794
群馬県,1002,渋川,4,194,193,199,164,174,137,106,1167,156,194,210,159,154,170,186,1229
群馬県,1002,渋川,5,224,319,318,255,298,292,387,2093,101,153,204,186,234,345,495,1718
群馬県,1003,伊勢崎,1,1384,1692,1613,1364,1199,980,1123,9355,726,895,888,684,588,657,997,5435
群馬県,1003,伊勢崎,2,1641,1940,1800,1405,1085,751,741,9363,1465,1763,1681,1231,1007,860,1006,9013
群馬県,1003,伊勢崎,3,768,904,768,719,640,707,998,5504,660,865,903,775,769,1132,1582,6686
群馬県,1003,伊勢崎,4,467,560,542,416,316,184,160,2645,363,424,433,351,286,210,201,2268
群馬県,1003,伊勢崎,5,611,842,896,800,670,614,682,5115,262,414,495,518,473,562,794,3518
群馬県,1004,高崎・安中,1,1850,2522,2434,2027,1757,1720,2292,14602,961,1391,1350,1121,1084,1294,2302,9503
群馬県,1004,高崎・安中,2,2783,3338,3228,2556,1809,1234,1038,15986,2477,3043,2982,2413,1715,1315,1116,15061
群馬県,1004,高崎・安中,3,1151,1277,1268,1036,823,846,1163,7564,985,1313,1246,1130,1140,1741,2374,9929
群馬県,1004,高崎・安中,4,745,925,902,700,471,309,234,4286,487,649,714,546,399,303,327,3425
群馬県,1004,高崎・安中,5,927,1378,1446,1284,1129,1006,1173,8343,419,637,823,756,669,841,1222,5367
群馬県,1005,藤岡,1,247,361,387,309,299,317,541,2461,136,176,199,177,194,244,513,1639
群馬県,1005,藤岡,2,382,493,415,376,306,224,186,2382,307,410,419,357,274,239,234,2240
群馬県,1005,藤岡,3,161,212,184,152,113,82,85,989,104,182,173,150,134,136,133,1012
群馬県,1005,藤岡,4,99,138,114,105,85,76,79,696,64,91,110,99,96,121,124,705
群馬県,1005,藤岡,5,127,198,187,178,170,206,275,1341,60,95,125,118,147,230,329,1104
群馬県,1006,富岡,1,256,347,338,371,365,381,508,2566,142,206,221,207,200,219,354,1549
群馬県,1006,富岡,2,383,458,423,373,347,329,278,2591,328,470,421,383,347,421,443,2813
群馬県,1006,富岡,3,151,190,178,159,151,165,145,1139,144,191,204,187,199,216,272,1413
群馬県,1006,富岡,4,106,113,101,119,105,88,81,713,83,101,101,119,131,131,112,778
群馬県,1006,富岡,5,139,206,210,217,225,280,363,1640,71,104,147,156,205,307,384,1374
群馬県,1007,吾妻,1,189,286,294,324,389,390,507,2379,103,143,176,196,203,227,370,1418
群馬県,1007,吾妻,2,243,322,335,301,315,288,310,2114,234,299,332,293,343,305,346,2152
群馬県,1007,吾妻,3,115,144,122,104,104,99,98,786,98,132,134,127,118,115,141,865
群馬県,1007,吾妻,4,63,93,94,75,81,74,70,550,60,87,79,90,89,101,97,603
群馬県,1007,吾妻,5,73,102,135,125,128,168,185,916,31,58,85,98,113,174,252,811
群馬県,1008,沼田,1,317,407,412,423,490,576,728,3353,189,253,237,264,324,431,677,2375
群馬県,1008,沼田,2,402,523,514,456,417,388,342,3042,390,519,485,513,450,409,358,3124
群馬県,1008,沼田,3,178,204,208,200,188,151,131,1260,160,216,187,198,224,201,185,1371
群馬県,1008,沼田,4,108,137,135,126,117,140,107,870,84,137,124,127,145,186,168,971
群馬県,1008,沼田,5,106,149,195,198,206,244,320,1418,74,104,151,150,213,286,375,1353
群馬県,1009,桐生,1,713,907,955,811,724,778,1345,6233,343,492,542,459,519,750,1509,4614
群馬県,1009,桐生,2,814,1052,1043,843,707,477,456,5392,744,990,1081,825,659,556,558,5413
群馬県,1009,桐生,3,382,468,475,366,340,234,211,2476,356,474,435,380,365,322,331,2663
群馬県,1009,桐生,4,272,345,321,275,205,177,211,1806,194,273,275,239,205,225,308,1719
群馬県,1009,桐生,5,338,524,531,455,446,441,620,3355,142,269,338,287,351,532,734,2653
群馬県,1010,太田・館林,1,2286,2835,2465,1958,1561,1496,2124,14725,978,1273,1162,918,862,1156,1948,8297
群馬県,1010,太田・館林,2,2700,2907,2645,2086,1522,1328,1579,14767,1915,2546,2321,1657,1402,1585,2076,13502
群馬県,1010,太田・館林,3,1243,1360,1368,1044,771,633,705,7124,922,1205,1106,874,805,828,1008,6748
群馬県,1010,太田・館林,4,933,1049,910,654,446,421,432,4845,532,668,661,530,458,504,616,3969
群馬県,1010,太田・館林,5,1111,1453,1518,1287,942,957,1427,8695,408,645,746,726,709,1009,1502,5745
埼玉県,1101,南部,1,4134,5087,4909,3935,2909,2369,3090,26433,2256,2747,2628,2178,1799,1674,3141,16423
埼玉県,1101,南部,2,5669,6218,5980,4304,2890,1835,1732,28628,4652,5403,5160,3877,2569,1832,2152,25645
埼玉県,1101,南部,3,2602,2824,2729,2035,1478,1086,1157,13911,2205,2656,2560,1896,1437,1298,1827,13879
埼玉県,1101,南部,4,2047,2262,1961,1372,874,587,489,9592,1334,1596,1516,1225,856,638,650,7815
埼玉県,1101,南部,5,2121,3006,3250,2728,1925,1526,1765,16321,1022,1562,1806,1578,1308,1275,1935,10486
埼玉県,1102,南西部,1,3495,4384,4332,3373,2400,2168,2988,23140,2035,2519,2362,1916,1511,1663,3241,15247
埼玉県,1102,南西部,2,5401,5953,5632,4250,2836,1993,2140,28205,4639,5482,5350,3924,2561,2121,2772,26849
埼玉県,1102,南西部,3,2400,2687,2656,1990,1376,1039,1240,13388,2318,2743,2619,2066,1445,1410,1968,14569
埼玉県,1102,南西部,4,1754,1923,1655,1330,863,618,672,8815,1189,1404,1438,1181,824,709,927,7672
埼玉県,1102,南西部,5,1935,2708,2895,2548,1885,1511,2069,15551,1004,1400,1730,1535,1287,1427,2360,10743
埼玉県,1103,東部,1,5151,6724,6807,5025,3881,3455,5002,36045,2995,3724,3725,2942,2421,2797,5073,23677
埼玉県,1103,東部,2,7272,8660,8019,5746,3832,2789,2878,39196,6411,8055,7513,5403,3909,3235,3911,38437
埼玉県,1103,東部,3,3366,4175,3931,2873,2236,1994,2660,21235,3362,3941,3974,2967,2431,2868,4567,24110
埼玉県,1103,東部,4,2403,2888,2435,1878,1214,992,1145,12955,1631,2132,2145,1583,1213,1161,1590,11455
埼玉県,1103,東部,5,2554,3846,3886,3259,2504,2307,3463,21819,1315,2044,2304,2154,1896,2543,4331,16587
埼玉県,1104,さいたま,1,6379,7942,7750,6382,5210,4493,6683,44839,4211,4952,4915,4394,4078,5293,9440,37283
埼玉県,1104,さいたま,2,9820,10557,9805,7440,5273,3298,2850,49043,8215,9257,8932,6603,4432,2740,2799,42978
埼玉県,1104,さいたま,3,4225,4596,4437,3473,2554,1483,1178,21946,3667,4328,4216,3133,2123,1441,1265,20173
埼玉県,1104,さいたま,4,3326,3745,3420,2605,1765,1151,957,16969,2216,2591,2645,2071,1436,989,986,12934
埼玉県,1104,さいたま,5,3768,5322,5875,5069,4058,2938,3293,30323,1646,2439,2955,2778,2172,1951,2378,16319
埼玉県,1105,県央,1,2471,3168,3242,2563,2043,2022,2955,18464,1309,1699,1797,1494,1220,1691,3429,12639
埼玉県,1105,県央,2,3472,4132,3933,3002,2234,1671,1711,20155,2802,3707,3561,2657,1981,1714,1968,18390
埼玉県,1105,県央,3,1637,1988,1882,1456,1187,1123,1501,10774,1418,1797,1868,1467,1413,1674,2555,12192
埼玉県,1105,県央,4,1105,1431,1233,979,783,566,497,6594,673,925,998,841,630,564,694,5325
埼玉県,1105,県央,5,1202,1858,2064,1797,1566,1414,1945,11846,534,837,1113,1008,1011,1293,2019,7815
埼玉県,1106,川越比企,1,3723,4805,4549,3612,3049,2817,3896,26451,1806,2340,2293,1830,1701,1949,3280,15199
埼玉県,1106,川越比企,2,5227,6074,5680,4229,3395,2640,2738,29983,4230,5122,5028,3702,3235,2931,3515,27763
埼玉県,1106,川越比企,3,2434,2900,2582,2036,1634,1315,1403,14304,2076,2587,2393,2026,1692,1703,2034,14511
埼玉県,1106,川越比企,4,1662,1939,1779,1321,1103,876,1069,9749,964,1303,1330,1123,1041,1142,1437,8340
埼玉県,1106,川越比企,5,1730,2581,2856,2495,2121,2130,2998,16911,826,1207,1481,1542,1563,2129,3422,12170
埼玉県,1107,西部,1,3338,4536,4369,3706,3095,2747,3757,25548,1985,2515,2448,2025,1851,2088,3576,16488
埼玉県,1107,西部,2,4547,5522,5422,4177,3018,2150,2027,26863,3978,4854,4676,3600,2686,2024,2191,24009
埼玉県,1107,西部,3,2189,2631,2567,1958,1606,1382,1551,13884,2089,2590,2552,2110,1822,1831,2304,15298
埼玉県,1107,西部,4,1505,1862,1723,1370,1121,844,880,9305,1030,1343,1320,1222,982,959,1140,7996
埼玉県,1107,西部,5,1654,2527,2819,2536,2280,2155,2879,16850,831,1242,1645,1629,1537,1936,2862,11682
埼玉県,1108,利根,1,2639,3627,3406,2632,2517,2466,3162,20449,1443,1775,1731,1424,1412,1681,2922,12388
埼玉県,1108,利根,2,3778,4546,4165,3227,2803,2316,2472,23307,3103,3805,3571,2934,2672,2684,3212,21981
埼玉県,1108,利根,3,1600,1967,1806,1410,1268,1207,1300,10558,1458,1758,1716,1510,1460,1620,2032,11554
埼玉県,1108,利根,4,1230,1524,1254,982,824,770,783,7367,760,1036,1076,924,810,925,1086,6617
埼玉県,1108,利根,5,1300,1827,1969,1832,1696,1801,2378,12803,551,925,1075,1163,1188,1690,2606,9198
埼玉県,1109,北部,1,2490,3060,2793,2338,2169,1865,2280,16995,1142,1567,1493,1338,1261,1297,1903,10001
埼玉県,1109,北部,2,3035,3495,3347,2618,2121,1818,1537,17971,2718,3162,3084,2477,2057,1785,1817,17100
埼玉県,1109,北部,3,1534,1669,1627,1343,1168,1022,1037,9400,1417,1747,1669,1497,1365,1383,1367,10445
埼玉県,1109,北部,4,1010,1100,1008,842,679,544,432,5615,608,860,851,751,680,591,592,4933
埼玉県,1109,北部,5,1056,1457,1581,1465,1297,1327,1509,9692,515,756,920,936,1014,1174,1542,6857
埼玉県,1110,秩父,1,369,426,473,447,498,436,562,3211,152,234,268,218,244,279,364,1759
埼玉県,1110,秩父,2,435,507,557,472,453,451,400,3275,377,511,517,466,483,507,493,3354
埼玉県,1110,秩父,3,190,233,219,230,204,190,158,1424,186,239,248,258,233,220,178,1562
埼玉県,1110,秩父,4,126,143,143,141,136,116,57,862,132,161,125,124,143,154,101,940
埼玉県,1110,秩父,5,162,245,287,243,254,315,405,1911,72,131,163,192,206,312,478,1554
千葉県,1201,千葉,1,4529,5791,5995,4644,3527,2569,3270,30325,2611,3262,3385,2620,2019,1829,3044,18770
千葉県,1201,千葉,2,6273,7627,7516,5407,3904,2587,2702,36016,5090,6628,6561,4855,3364,2860,3903,33261
千葉県,1201,千葉,3,2745,3300,3340,2520,1707,1115,1192,15919,2532,3083,3277,2364,1811,1403,1889,16359
千葉県,1201,千葉,4,2115,2604,2582,1885,1327,779,824,12116,1552,1957,2102,1585,1100,938,1240,10474
千葉県,1201,千葉,5,2347,3899,4363,3840,2883,2228,3005,22565,1199,1895,2364,2139,1808,2013,3241,14659
千葉県,1202,東葛南部,1,8503,10871,10895,8451,5961,4356,5273,54310,5173,6335,6295,4832,3633,3248,5450,34966
千葉県,1202,東葛南部,2,12347,13754,13326,9673,5873,3389,2628,60990,10824,12611,11978,8438,5353,3336,3224,55764
千葉県,1202,東葛南部,3,5404,6201,5969,4333,2911,1751,1698,28267,5087,6170,5977,4363,2827,1990,2319,28733
千葉県,1202,東葛南部,4,4432,5094,4655,3497,2193,1286,1340,22497,3150,3714,3795,2811,1889,1575,1885,18819
千葉県,1202,東葛南部,5,4783,6973,7644,6432,4677,3187,3567,37263,2344,3561,4128,3572,2774,2651,3559,22589
千葉県,1203,東葛北部,1,6645,8302,8226,6220,4885,4128,5983,44389,4097,5161,4827,3847,3276,3457,6038,30703
千葉県,1203,東葛北部,2,9383,10320,9517,6865,4960,3618,3524,48187,8223,9232,8811,6549,4741,4129,5119,46804
千葉県,1203,東葛北部,3,4110,4695,4380,3267,2293,1668,1667,22080,3690,4409,4165,3183,2353,2177,2571,22548
千葉県,1203,東葛北部,4,3397,3848,3298,2521,1869,1428,1596,17957,2362,2825,2794,2245,1828,1804,2458,16316
千葉県,1203,東葛北部,5,3718,5278,5547,4854,3801,3330,4387,30915,1923,2727,3111,2965,2465,3156,4787,21134
千葉県,1204,印旛,1,3073,3662,3548,2855,2647,2605,2995,21385,1722,2041,1973,1650,1625,1751,2257,13019
千葉県,1204,印旛,2,4054,4650,4279,3243,2670,2312,2448,23656,3680,4359,4081,3216,2835,2721,2950,23842
千葉県,1204,印旛,3,1861,2164,2030,1498,1354,1117,987,11011,1848,2227,1931,1541,1463,1372,1357,11739
千葉県,1204,印旛,4,1401,1667,1432,1084,984,811,796,8175,1030,1288,1273,1041,1003,993,1095,7723
千葉県,1204,印旛,5,1652,2260,2397,2144,1976,2312,3055,15796,860,1251,1481,1473,1590,2118,2907,11680
千葉県,1205,香取海匝,1,999,1301,1296,1242,1340,1440,1877,9495,499,680,744,742,818,1056,1488,6027
千葉県,1205,香取海匝,2,1180,1408,1420,1212,1150,1094,1070,8534,1027,1215,1301,1277,1425,1493,1574,9312
千葉県,1205,香取海匝,3,473,536,524,485,462,395,434,3309,434,506,585,539,595,668,721,4048
千葉県,1205,香取海匝,4,355,425,374,310,299,269,317,2349,296,352,366,340,389,415,463,2621
千葉県,1205,香取海匝,5,358,533,591,546,606,735,986,4355,184,276,393,396,571,813,1138,3771
千葉県,1206,山武長生夷隅,1,1723,2303,2284,2174,2183,2320,2934,15921,954,1210,1342,1243,1324,1520,2130,9723
千葉県,1206,山武長生夷隅,2,1909,2298,2192,1863,1702,1610,1695,13269,1755,2061,2062,2012,1959,1894,2046,13789
千葉県,1206,山武長生夷隅,3,831,1027,946,836,753,715,668,5776,768,981,1039,903,945,958,839,6433
千葉県,1206,山武長生夷隅,4,628,743,724,557,555,497,510,4214,450,595,642,573,566,607,550,3983
千葉県,1206,山武長生夷隅,5,734,1012,1142,1059,1122,1212,1534,7815,334,529,720,718,878,1187,1728,6094
千葉県,1207,安房,1,369,523,568,503,508,485,576,3532,238,325,318,252,339,315,495,2282
千葉県,1207,安房,2,479,541,531,431,402,383,388,3155,470,551,574,443,430,485,561,3514
千葉県,1207,安房,3,171,203,254,196,178,132,151,1285,198,287,240,208,184,194,198,1509
千葉県,1207,安房,4,156,201,178,134,145,99,116,1029,154,208,198,155,150,133,146,1144
千葉県,1207,安房,5,168,266,286,234,256,278,306,1794,97,156,193,222,197,314,396,1575
千葉県,1208,君津,1,1507,1883,1710,1511,1486,1654,2174,11925,704,893,868,808,778,1152,2030,7233
千葉県,1208,君津,2,1918,2313,2141,1584,1390,1327,1521,12194,1542,1921,1852,1436,1341,1549,2098,11739
千葉県,1208,君津,3,815,917,858,662,559,558,538,4907,769,836,833,712,595,667,847,5259
千葉県,1208,君津,4,699,797,672,507,425,378,311,3789,434,515,527,441,398,412,370,3097
千葉県,1208,君津,5,758,1054,1064,966,900,888,1075,6705,313,470,548,528,555,793,1009,4216
千葉県,1209,市原,1,1165,1549,1465,1180,1090,1307,1743,9499,538,773,699,673,730,1067,1660,6140
千葉県,1209,市原,2,1351,1667,1556,1177,1009,954,871,8585,1186,1564,1497,1165,1078,1091,1154,8735
千葉県,1209,市原,3,542,719,671,523,424,467,420,3766,611,698,740,609,582,605,671,4516
千葉県,1209,市原,4,441,531,478,361,330,291,264,2696,348,418,399,322,299,355,313,2454
千葉県,1209,市原,5,487,716,799,708,639,810,986,5145,299,396,514,452,503,687,968,3819
東京都,1301,区中央部,1,7807,9084,8660,7066,4834,2653,2780,42884,4745,5199,4571,3508,2511,1903,2937,25374
東京都,1301,区中央部,2,12409,12752,11664,8603,5430,2493,1824,55175,10388,10654,9181,6293,3901,2136,2332,44885
東京都,1301,区中央部,3,5623,5874,5430,4293,2727,1309,1125,26381,5230,5586,5123,3437,2258,1383,1451,24468
東京都,1301,区中央部,4,5104,5377,4592,3657,2199,932,625,22486,3372,3631,3298,2281,1340,849,784,15555
東京都,1301,区中央部,5,6058,7618,8122,7328,4866,2347,1856,38195,3147,3864,4086,3342,2194,1540,1913,20086
東京都,1302,区南部,1,6339,7419,7530,5812,4175,2921,3863,38059,3968,4625,4205,3207,2569,2349,4034,24957
東京都,1302,区南部,2,9604,9925,9382,6908,4626,2942,2999,46386,9157,9657,8618,6077,4115,3228,3948,44800
東京都,1302,区南部,3,4176,4745,4342,3262,2157,1295,1267,21244,4549,5044,4523,3191,2070,1549,1726,22652
東京都,1302,区南部,4,3686,3977,3701,2688,1640,933,883,17508,2850,3172,2930,2084,1421,1084,1314,14855
東京都,1302,区南部,5,4345,5682,6376,5198,3563,2297,2772,30233,2453,3356,3644,2978,2172,2204,3207,20014
東京都,1303,区西南部,1,5522,6096,5999,5235,3886,3009,3974,33721,4423,4943,4634,3945,3177,2891,4955,28968
東京都,1303,区西南部,2,9517,9378,8133,6438,4381,2486,2368,42701,10802,11233,9738,7137,4680,3182,3513,50285
東京都,1303,区西南部,3,4936,4836,4293,3605,2581,1783,1997,24031,6006,6577,6153,4551,3229,2684,3340,32540
東京都,1303,区西南部,4,3933,4052,3360,2689,1734,1054,938,17760,3625,3975,3519,2704,1848,1277,1305,18253
東京都,1303,区西南部,5,4804,6147,6600,6107,4316,2850,3161,33985,3461,4377,4803,4135,3258,2713,3721,26468
東京都,1304,区西部,1,5720,6412,6076,5123,3754,3127,4079,34291,4354,4760,4442,3841,3231,2919,4976,28523
東京都,1304,区西部,2,9807,9590,8535,6490,4436,2919,2788,44565,10082,10451,9347,7064,4957,3423,3738,49062
東京都,1304,区西部,3,4578,4399,3989,3046,2170,1317,1248,20747,4926,5360,4761,3595,2521,1640,1712,24515
東京都,1304,区西部,4,3658,3663,3113,2508,1692,1052,1000,16686,3106,3311,3127,2465,1679,1350,1497,16535
東京都,1304,区西部,5,4477,5402,5469,5008,3794,2607,2917,29674,2690,3362,3873,3449,2772,2540,3635,22321
東京都,1305,区西北部,1,9037,10276,10038,8426,6829,5486,7268,57360,6240,7257,7150,6123,5555,5220,8181,45726
東京都,1305,区西北部,2,14211,14555,13378,10401,7759,5606,5778,71688,13733,14926,14171,11184,8467,6886,8146,77513
東京都,1305,区西北部,3,6535,6687,6091,4838,3557,2466,2444,32618,6696,7423,7141,5465,4090,3225,3807,37847
東京都,1305,区西北部,4,5116,5218,4409,3501,2480,1625,1536,23885,3892,4403,4217,3406,2530,2123,2424,22995
東京都,1305,区西北部,5,5789,7409,7909,6873,5561,4116,4748,42405,3178,4439,5021,4781,4029,4044,5731,31223
東京都,1306,区東北部,1,5892,7522,7464,6120,4806,4272,6235,42311,3943,4601,4848,4058,3401,3626,6489,30966
東京都,1306,区東北部,2,8397,9383,8923,6690,4980,3970,4635,46978,7701,8878,8668,6951,5171,4807,6216,48392
東京都,1306,区東北部,3,4332,4934,4586,3658,2688,2074,2087,24359,4418,5422,5260,4260,3206,2570,3063,28199
東京都,1306,区東北部,4,2981,3410,2806,2127,1518,1125,1296,15263,2253,2660,2557,2101,1666,1501,1942,14680
東京都,1306,区東北部,5,3229,4474,4862,4084,3072,2533,3226,25480,1821,2518,3007,2888,2438,2612,3992,19276
東京都,1307,区東部,1,7682,9702,9982,7631,5353,3943,5058,49351,4852,5826,5706,4214,3293,3089,5556,32536
東京都,1307,区東部,2,11704,12855,12479,9022,5782,3675,3523,59040,10811,12064,11451,7826,5253,3946,4765,56116
東京都,1307,区東部,3,5440,6066,5656,4286,2744,1780,1705,27677,5495,6214,6146,4362,2836,2218,2501,29772
東京都,1307,区東部,4,4329,4777,4433,3183,1864,1127,1098,20811,3065,3683,3507,2568,1680,1355,1567,17425
東京都,1307,区東部,5,4845,6550,7212,6074,3794,2545,2885,33905,2651,3542,4000,3249,2352,2282,3246,21322
東京都,1308,西多摩,1,1700,2223,2377,1840,1623,1645,2448,13856,979,1250,1276,1089,1061,1299,2326,9280
東京都,1308,西多摩,2,1882,2333,2481,1974,1534,1464,1728,13396,1793,2363,2387,1931,1634,1724,2247,14079
東京都,1308,西多摩,3,997,1206,1265,1028,809,726,883,6914,925,1218,1329,1138,961,948,1223,7742
東京都,1308,西多摩,4,723,870,865,712,580,501,617,4868,570,722,850,686,614,600,865,4907
東京都,1308,西多摩,5,858,1237,1485,1350,1145,1150,1823,9048,448,695,939,963,910,1278,2133,7366
東京都,1309,南多摩,1,6105,7691,8014,6322,4948,4107,5964,43151,3896,4809,4809,3856,3185,3557,6140,30252
東京都,1309,南多摩,2,8577,9981,10190,7982,5357,4291,5413,51791,8119,9780,9840,7471,5697,5386,7523,53816
東京都,1309,南多摩,3,4344,5115,5148,4070,2842,2140,2346,26005,4238,5424,5539,4344,3228,2803,3430,29006
東京都,1309,南多摩,4,3138,3670,3724,2998,2043,1633,2199,19405,2389,2969,3168,2605,2129,2358,3306,18924
東京都,1309,南多摩,5,3608,5227,6143,5596,4449,4165,6195,35383,1945,2937,3794,3693,3545,4107,7019,27040
東京都,1310,北多摩西部,1,3036,3485,3579,3190,2376,2033,3017,20716,1785,2177,2100,1823,1552,1746,3366,14549
東京都,1310,北多摩西部,2,4160,4665,4538,3605,2581,1751,1846,23146,3763,4220,4192,3336,2411,1935,2436,22293
東京都,1310,北多摩西部,3,1919,2230,2210,1823,1293,1122,1356,11953,1876,2245,2348,1941,1489,1524,2047,13470
東京都,1310,北多摩西部,4,1477,1741,1567,1290,936,653,711,8375,1074,1315,1363,1155,925,797,984,7613
東京都,1310,北多摩西部,5,1682,2402,2591,2602,2061,1665,2257,15260,877,1297,1613,1564,1391,1614,2593,10949
東京都,1311,北多摩南部,1,4541,5072,5141,4565,3457,2779,4021,29576,3205,3621,3585,2933,2543,2439,4146,22472
東京都,1311,北多摩南部,2,7582,7803,7264,5922,4135,2931,3341,38978,7960,8296,7946,6195,4564,3783,4614,43358
東京都,1311,北多摩南部,3,3428,3434,3395,2766,1938,1302,1324,17587,3573,4062,3938,2976,2237,1693,1977,20456
東京都,1311,北多摩南部,4,2983,2885,2752,2287,1494,1027,1183,14611,2220,2595,2574,2149,1483,1365,1700,14086
東京都,1311,北多摩南部,5,3329,4473,4905,4599,3470,2847,3673,27296,1827,2597,3182,3006,2546,2752,4026,19936
東京都,1312,北多摩北部,1,3213,3908,3903,3444,2768,2419,3562,23217,2085,2471,2508,2175,2051,2158,3926,17374
東京都,1312,北多摩北部,2,4772,5070,4945,4003,2830,1876,1868,25364,4493,4968,5130,4016,2794,2011,2271,25683
東京都,1312,北多摩北部,3,2265,2543,2604,2234,1695,1480,1835,14656,2394,2869,2963,2578,2127,2173,2922,18026
東京都,1312,北多摩北部,4,1697,1920,1819,1458,1103,778,795,9570,1256,1605,1605,1412,1144,971,1220,9213
東京都,1312,北多摩北部,5,1976,2726,3016,3013,2420,2013,2633,17797,1083,1515,1906,2032,1783,2085,3078,13482
東京都,1313,島しょ,1,88,109,100,122,105,133,172,829,61,75,87,57,76,87,148,591
東京都,1313,島しょ,2,112,132,116,97,76,86,92,711,119,128,117,80,100,114,118,776
東京都,1313,島しょ,3,70,81,83,70,61,51,49,465,69,79,79,60,51,54,52,444
東京都,1313,島しょ,4,36,42,55,35,37,27,32,264,48,44,37,33,31,39,33,265
東京都,1313,島しょ,5,51,56,69,65,38,49,61,389,44,43,45,34,48,50,71,335
神奈川県,1404,川崎北部,1,4058,4906,4907,4094,2842,1959,2296,25062,2630,3046,2990,2381,1804,1526,2366,16743
神奈川県,1404,川崎北部,2,6349,6679,6406,5117,3026,1839,1834,31250,5720,6356,6158,4595,2952,1965,2458,30204
神奈川県,1404,川崎北部,3,2817,3029,3018,2359,1536,890,809,14458,2944,3318,3361,2354,1590,994,1036,15597
神奈川県,1404,川崎北部,4,2310,2428,2319,1886,1191,770,623,11527,1614,1886,1843,1565,1024,747,748,9427
神奈川県,1404,川崎北部,5,2472,3369,3992,3571,2381,1547,1653,18985,1343,1799,2303,2027,1522,1285,1616,11895
神奈川県,1405,川崎南部,1,3983,4736,4508,3275,2464,1718,1776,22460,2390,2539,2333,1772,1364,1105,1718,13221
神奈川県,1405,川崎南部,2,5775,6158,5352,3800,2457,1476,1265,26283,4883,5214,4619,3095,2024,1376,1483,22694
神奈川県,1405,川崎南部,3,2377,2556,2224,1676,987,526,447,10793,2243,2285,2071,1416,878,574,501,9968
神奈川県,1405,川崎南部,4,1951,2083,1755,1324,807,447,310,8677,1378,1465,1322,1014,600,420,346,6545
神奈川県,1405,川崎南部,5,2310,3103,3041,2442,1661,1044,991,14592,1077,1411,1474,1396,962,766,916,8002
神奈川県,1406,横須賀・三浦,1,2623,3629,4035,3417,2767,2212,2827,21510,1531,2123,2217,1823,1542,1608,2708,13552
神奈川県,1406,横須賀・三浦,2,3429,4648,4688,3743,2907,1991,2020,23426,3368,4359,4555,3483,2535,2071,2455,22826
神奈川県,1406,横須賀・三浦,3,1438,1863,1895,1689,1211,944,1016,10056,1531,2078,2142,1720,1350,1119,1464,11404
神奈川県,1406,横須賀・三浦,4,1180,1636,1580,1325,1009,650,782,8162,991,1326,1438,1086,833,798,1051,7523
神奈川県,1406,横須賀・三浦,5,1449,2312,2799,2513,2169,1611,2076,14929,835,1285,1709,1554,1374,1524,2159,10440
神奈川県,1407,湘南東部,1,3740,4625,4616,3884,2748,2166,3256,25035,2074,2593,2514,2063,1725,1790,3766,16525
神奈川県,1407,湘南東部,2,4666,5373,5298,4085,2752,1695,1855,25724,4342,5114,4875,3491,2425,1950,2492,24689
神奈川県,1407,湘南東部,3,1897,2294,2258,1810,1234,716,800,11009,1950,2443,2318,1700,1218,919,1219,11767
神奈川県,1407,湘南東部,4,1778,2119,2019,1587,1106,675,793,10077,1283,1584,1638,1327,942,937,1298,9009
神奈川県,1407,湘南東部,5,2055,3006,3474,3020,2304,1692,2494,18045,1131,1598,1894,1776,1490,1756,3084,12729
神奈川県,1408,湘南西部,1,2674,3452,3439,2907,2388,2048,2812,19720,1533,1875,1825,1523,1353,1500,2684,12293
神奈川県,1408,湘南西部,2,3364,3979,3865,3067,2185,1651,2014,20125,2722,3526,3387,2612,2091,1816,2537,18691
神奈川県,1408,湘南西部,3,1315,1549,1554,1361,949,721,758,8207,1261,1582,1540,1234,974,902,1161,8654
神奈川県,1408,湘南西部,4,1217,1295,1284,1067,777,605,700,6945,781,943,1099,909,673,718,978,6101
神奈川県,1408,湘南西部,5,1281,1940,2250,2060,1700,1394,2133,12758,630,1018,1179,1188,1045,1404,2305,8769
神奈川県,1409,県央,1,4634,5885,5915,4646,3525,2648,3701,30954,2288,2964,2911,2250,1866,1952,3836,18067
神奈川県,1409,県央,2,5722,6593,6469,4905,3316,2164,2542,31711,4428,5601,5288,3972,2796,2403,3465,27953
神奈川県,1409,県央,3,2250,2674,2599,1978,1334,909,1119,12863,1928,2503,2458,1784,1337,1196,1682,12888
神奈川県,1409,県央,4,1977,2254,2191,1697,1164,775,906,10964,1226,1609,1651,1276,985,942,1329,9018
神奈川県,1409,県央,5,2084,3083,3360,3103,2299,1866,2632,18427,987,1517,1866,1756,1496,1773,3210,12605
神奈川県,1410,相模原,1,3529,4526,4627,3718,2731,2034,2447,23612,1981,2445,2378,1996,1575,1423,2372,14170
神奈川県,1410,相模原,2,4674,5373,5146,3976,2689,1857,1830,25545,3855,4520,4503,3426,2413,1814,2332,22863
神奈川県,1410,相模原,3,1888,2064,2069,1668,1180,699,698,10266,1629,1956,1997,1563,1116,858,1090,10209
神奈川県,1410,相模原,4,1552,1837,1694,1340,923,592,626,8564,1033,1305,1354,1081,863,678,876,7190
神奈川県,1410,相模原,5,1673,2376,2747,2513,1841,1498,2048,14696,807,1290,1590,1541,1209,1376,2092,9905
神奈川県,1411,県西,1,1775,2198,2248,2015,1531,1153,1626,12546,873,1112,1047,886,782,848,1490,7038
神奈川県,1411,県西,2,2043,2533,2532,2140,1493,944,1008,12693,1603,2061,2070,1626,1286,1084,1325,11055
神奈川県,1411,県西,3,773,946,906,772,542,394,457,4790,648,811,890,647,549,504,708,4757
神奈川県,1411,県西,4,624,760,782,633,463,339,321,3922,432,530,594,474,400,400,482,3312
神奈川県,1411,県西,5,820,1051,1281,1286,968,710,1018,7134,297,505,654,576,577,752,1243,4604
神奈川県,1412,横浜,1,17749,22308,23281,19182,13974,9428,10322,116244,10617,13040,13369,10575,7963,6274,8715,70553
神奈川県,1412,横浜,2,26381,29695,29503,22880,15352,9538,8626,141975,23608,27930,27538,20280,13726,9346,10363,132791
神奈川県,1412,横浜,3,10566,12188,12322,9733,6568,4103,3966,59446,10213,12415,12739,9556,6447,4597,5115,61082
神奈川県,1412,横浜,4,9184,10710,10459,8080,5343,3214,2771,49761,6418,7962,8440,6593,4533,3237,3459,40642
神奈川県,1412,横浜,5,10396,15133,17775,16370,12274,8572,9761,90281,5328,7895,10107,9340,7387,6936,9300,56293
新潟県,1501,下越,1,1182,1385,1451,1437,1478,1507,1862,10302,738,883,955,950,1062,1280,1733,7601
新潟県,1501,下越,2,1464,1568,1498,1359,1242,1117,1211,9459,1345,1611,1562,1395,1332,1247,1251,9743
新潟県,1501,下越,3,526,555,562,522,459,375,356,3355,445,539,569,490,442,495,472,3452
新潟県,1501,下越,4,365,391,355,300,224,224,180,2039,304,375,348,304,291,319,302,2243
新潟県,1501,下越,5,358,524,509,490,467,514,654,3516,190,288,306,339,385,548,838,2894
新潟県,1502,新潟,1,5364,6745,6075,5512,5079,4324,4991,38090,3110,4003,3506,3317,3116,3284,4600,24936
新潟県,1502,新潟,2,6809,7791,7087,5724,4589,3631,3516,39147,6319,7480,6742,5712,4691,4001,4512,39457
新潟県,1502,新潟,3,2655,2941,2635,2223,1745,1497,1465,15161,2321,2756,2562,2197,1884,1716,1916,15352
新潟県,1502,新潟,4,1806,2144,1821,1416,1150,896,824,10057,1310,1619,1520,1376,1177,1092,1156,9250
新潟県,1502,新潟,5,2109,2931,2872,2533,2267,2214,2756,17682,968,1389,1600,1564,1668,2232,3246,12667
新潟県,1503,県央,1,1432,1790,1724,1558,1498,1417,1605,11024,809,1076,1132,1047,1001,1103,1387,7555
新潟県,1503,県央,2,1564,1859,1773,1502,1311,989,936,9934,1488,1873,1746,1524,1283,1162,1095,10171
新潟県,1503,県央,3,575,619,611,539,410,339,319,3412,516,589,578,516,443,416,389,3447
新潟県,1503,県央,4,407,484,409,314,288,258,203,2363,299,370,354,326,296,300,303,2248
新潟県,1503,県央,5,506,627,636,588,503,558,599,4017,217,354,379,391,402,556,693,2992
新潟県,1504,中越,1,2730,3160,2931,2708,2854,2377,3059,19819,1701,2145,1872,1799,1769,2013,2754,14053
新潟県,1504,中越,2,3463,3852,3521,3108,2557,2022,2030,20553,3290,3929,3572,3068,2710,2240,2403,21212
新潟県,1504,中越,3,1256,1367,1247,1095,946,743,698,7352,1150,1305,1228,1075,935,896,972,7561
新潟県,1504,中越,4,880,966,839,675,575,511,553,4999,678,828,840,728,669,660,734,5137
新潟県,1504,中越,5,925,1328,1338,1216,1061,1162,1474,8504,486,694,820,896,1029,1364,2045,7334
新潟県,1505,魚沼,1,1003,1187,1070,1087,1290,1429,1714,8780,655,802,720,706,821,1027,1130,5861
新潟県,1505,魚沼,2,1055,1212,1117,1055,1007,955,838,7239,1050,1181,1151,1012,967,936,901,7198
新潟県,1505,魚沼,3,380,415,344,309,338,316,301,2403,359,414,394,368,362,357,324,2578
新潟県,1505,魚沼,4,315,295,244,232,241,236,229,1792,257,282,281,279,257,343,324,2023
新潟県,1505,魚沼,5,352,373,468,424,431,535,717,3300,205,237,324,352,417,611,777,2923
新潟県,1506,上越,1,1558,1742,1671,1592,1498,1098,825,9984,930,1168,982,974,720,571,605,5950
新潟県,1506,上越,2,1942,2259,2091,1820,1586,1064,777,11539,1723,2192,1966,1670,1452,848,631,10482
新潟県,1506,上越,3,568,683,589,560,489,330,197,3416,547,713,667,559,415,315,209,3425
新潟県,1506,上越,4,474,531,469,417,361,207,147,2606,361,419,414,392,344,191,141,2262
新潟県,1506,上越,5,707,986,974,907,887,558,491,5510,330,532,616,649,634,532,523,3816
新潟県,1507,佐渡,1,264,291,315,342,410,438,540,2600,139,176,171,191,270,283,443,1673
新潟県,1507,佐渡,2,350,392,437,390,386,339,399,2693,345,397,379,365,419,384,419,2708
新潟県,1507,佐渡,3,116,117,136,142,116,114,132,873,116,135,113,117,129,150,136,896
新潟県,1507,佐渡,4,97,80,79,67,71,67,74,535,65,65,86,76,71,79,107,549
新潟県,1507,佐渡,5,80,103,103,109,128,121,159,803,49,59,78,82,91,135,182,676
富山県,1601,新川,1,791,1122,1034,797,728,626,772,5870,466,674,652,583,441,477,887,4180
富山県,1601,新川,2,862,972,929,774,683,496,501,5217,814,1073,972,839,671,601,713,5683
富山県,1601,新川,3,256,316,315,278,255,223,251,1894,258,347,358,308,302,352,396,2321
富山県,1601,新川,4,231,291,217,197,173,125,112,1346,163,182,203,204,148,147,205,1252
富山県,1601,新川,5,233,338,388,334,330,327,362,2312,112,185,205,229,258,310,541,1840
富山県,1602,富山,1,3374,4410,4060,3292,2803,2196,2410,22545,1993,2402,2211,1874,1646,1505,2381,14012
富山県,1602,富山,2,3765,4370,4195,3072,2317,1768,1668,21155,3509,4430,4073,3138,2454,1999,2116,21719
富山県,1602,富山,3,1282,1513,1401,1063,856,624,610,7349,1115,1518,1421,1111,896,827,973,7861
富山県,1602,富山,4,1079,1364,1081,845,691,448,449,5957,782,975,977,843,659,551,603,5390
富山県,1602,富山,5,1161,1877,1915,1655,1349,1094,1339,10390,549,898,1103,1035,989,1082,1593,7249
富山県,1603,高岡,1,2196,2959,2653,2300,2033,1807,2489,16437,1143,1555,1435,1312,1173,1329,2514,10461
富山県,1603,高岡,2,2196,2617,2361,1750,1355,1060,1124,12463,1875,2440,2340,1791,1427,1235,1479,12587
富山県,1603,高岡,3,617,810,782,621,476,601,961,4868,624,864,915,749,789,1054,1536,6531
富山県,1603,高岡,4,628,717,653,512,366,327,325,3528,418,623,617,494,459,455,568,3634
富山県,1603,高岡,5,680,1122,1042,939,829,778,1150,6540,353,576,712,615,723,927,1660,5566
富山県,1604,砺波,1,748,1049,972,850,865,799,1173,6456,478,598,618,583,619,762,1213,4871
富山県,1604,砺波,2,794,902,775,648,616,516,587,4838,805,982,833,749,713,635,685,5402
富山県,1604,砺波,3,273,292,247,227,239,301,436,2015,224,317,299,288,320,453,646,2547
富山県,1604,砺波,4,231,262,217,205,147,127,139,1328,168,233,238,208,205,222,244,1518
富山県,1604,砺波,5,243,388,357,346,338,288,430,2390,121,205,235,230,257,376,587,2011
石川県,1701,南加賀,1,1225,1641,1316,1091,877,705,872,7727,761,992,867,725,635,524,736,5240
石川県,1701,南加賀,2,1303,1654,1383,1070,883,633,633,7559,1280,1623,1578,1299,1007,782,950,8519
石川県,1701,南加賀,3,634,786,716,581,448,304,249,3718,624,785,763,626,463,321,290,3872
石川県,1701,南加賀,4,425,524,444,390,284,168,169,2404,324,474,427,352,304,232,218,2331
石川県,1701,南加賀,5,563,897,898,777,656,486,604,4881,295,476,509,517,454,472,686,3409
石川県,1702,石川中央,1,3823,4790,4277,3387,2887,2378,3195,24737,2584,3102,2792,2280,2140,2109,3558,18565
石川県,1702,石川中央,2,4835,5720,5059,3804,2971,2470,3061,27920,4695,5813,5352,4218,3621,3425,4598,31722
石川県,1702,石川中央,3,2076,2532,2267,1683,1313,926,829,11626,1872,2370,2118,1658,1249,915,942,11124
石川県,1702,石川中央,4,1479,1760,1511,1163,910,620,542,7985,1064,1430,1331,1018,863,642,700,7048
石川県,1702,石川中央,5,1910,2918,2993,2564,2100,1539,1766,15790,945,1440,1567,1506,1287,1301,1782,9828
石川県,1703,能登中部,1,495,675,640,566,540,606,938,4460,321,469,411,389,416,542,932,3480
石川県,1703,能登中部,2,580,710,597,539,495,493,537,3951,484,675,607,607,572,637,735,4317
石川県,1703,能登中部,3,215,251,242,200,180,153,192,1433,226,293,261,254,209,215,277,1735
石川県,1703,能登中部,4,155,177,175,153,140,127,200,1127,115,169,188,165,177,236,258,1308
石川県,1703,能登中部,5,188,348,311,306,284,309,445,2191,105,177,185,211,277,432,648,2035
石川県,1704,能登北部,1,202,257,257,306,323,391,530,2266,146,209,203,194,234,307,537,1830
石川県,1704,能登北部,2,225,328,316,292,321,365,473,2320,242,281,341,337,371,439,614,2625
石川県,1704,能登北部,3,94,109,103,104,106,96,126,738,80,108,111,104,120,143,153,819
石川県,1704,能登北部,4,49,90,59,69,83,58,80,488,43,53,54,69,65,81,88,453
石川県,1704,能登北部,5,67,117,115,131,118,137,215,900,42,50,63,73,114,145,253,740
福井県,1801,福井・坂井,1,2251,2696,2461,2183,1869,1536,1547,14543,1336,1624,1515,1378,1204,990,1102,9149
福井県,1801,福井・坂井,2,2996,3461,3086,2538,2084,1466,1168,16799,2684,3324,3021,2536,2116,1470,1365,16516
福井県,1801,福井・坂井,3,1039,1215,1092,931,786,488,443,5994,1013,1193,1161,957,774,603,576,6277
福井県,1801,福井・坂井,4,722,906,811,669,586,345,318,4357,537,730,790,641,542,451,498,4189
福井県,1801,福井・坂井,5,791,1134,1276,1098,997,785,1060,7141,430,604,805,840,813,952,1327,5771
福井県,1802,奥越,1,287,360,331,334,356,319,351,2338,195,227,232,235,214,223,283,1609
福井県,1802,奥越,2,395,434,381,351,339,304,233,2437,385,407,391,403,365,324,271,2546
福井県,1802,奥越,3,147,132,119,114,98,96,89,795,129,151,143,125,141,135,130,954
福井県,1802,奥越,4,83,107,93,74,57,58,56,528,62,97,87,109,91,88,101,635
福井県,1802,奥越,5,86,125,119,101,113,120,142,806,62,62,100,96,116,147,175,758
福井県,1803,丹南,1,1143,1357,1132,984,871,632,685,6804,620,733,634,626,557,469,619,4258
福井県,1803,丹南,2,1528,1657,1456,1197,945,640,509,7932,1349,1536,1470,1181,973,666,666,7841
福井県,1803,丹南,3,492,560,463,417,287,192,190,2601,420,481,473,429,324,237,230,2594
福井県,1803,丹南,4,333,370,366,267,197,129,123,1785,260,300,308,250,211,159,173,1661
福井県,1803,丹南,5,371,505,471,430,367,263,311,2718,168,270,325,276,278,287,405,2009
福井県,1804,嶺南,1,675,858,776,826,663,551,685,5034,318,404,381,369,359,422,601,2854
福井県,1804,嶺南,2,916,996,943,750,722,574,515,5416,733,923,851,754,656,580,642,5139
福井県,1804,嶺南,3,306,325,339,276,273,217,198,1934,271,344,320,296,254,273,284,2042
福井県,1804,嶺南,4,229,259,227,185,175,141,139,1355,145,212,210,180,163,154,136,1200
福井県,1804,嶺南,5,242,336,349,329,343,327,326,2252,89,194,192,200,200,281,405,1561
山梨県,1901,中北,1,2141,2691,2729,2381,1974,1726,1925,15567,1348,1673,1692,1539,1355,1404,1923,10934
山梨県,1901,中北,2,2857,3297,3238,2548,1874,1363,895,16072,2530,3174,2881,2382,1854,1196,838,14855
山梨県,1901,中北,3,1389,1603,1408,1188,928,710,544,7770,1432,1752,1696,1357,1155,938,783,9113
山梨県,1901,中北,4,946,1059,950,804,628,412,371,5170,802,1010,945,841,717,599,494,5408
山梨県,1901,中北,5,1712,2214,2266,2364,2179,2611,3408,16754,1093,1596,1855,1980,2254,3151,4238,16167
山梨県,1902,峡東,1,577,745,754,713,697,661,792,4939,339,471,521,476,447,524,684,3462
山梨県,1902,峡東,2,819,1006,1026,825,693,567,479,5415,827,1025,1049,863,748,627,494,5633
山梨県,1902,峡東,3,337,401,445,337,303,220,242,2285,385,451,461,421,349,344,298,2709
山梨県,1902,峡東,4,237,283,264,211,175,149,149,1468,223,266,283,258,209,187,168,1594
山梨県,1902,峡東,5,361,505,563,513,507,569,736,3754,221,303,376,408,459,644,835,3246
山梨県,1903,峡南,1,222,263,279,311,351,380,423,2229,141,180,216,175,220,250,363,1545
山梨県,1903,峡南,2,259,301,329,304,307,237,201,1938,228,313,353,342,281,253,219,1989
山梨県,1903,峡南,3,108,142,140,133,137,122,85,867,103,150,141,178,155,160,144,1031
山梨県,1903,峡南,4,84,85,90,86,85,70,51,551,71,98,86,104,112,101,96,668
山梨県,1903,峡南,5,137,189,211,208,218,312,493,1768,86,123,143,187,248,376,536,1699
山梨県,1904,富士・東部,1,765,938,1017,1086,997,891,1064,6758,434,605,661,647,694,691,903,4635
山梨県,1904,富士・東部,2,1093,1192,1354,1240,1010,784,582,7255,935,1135,1307,1226,1022,766,598,6989
山梨県,1904,富士・東部,3,408,446,550,516,435,314,252,2921,400,466,537,477,399,360,301,2940
山梨県,1904,富士・東部,4,269,354,337,302,257,191,175,1885,246,272,326,309,284,287,228,1952
山梨県,1904,富士・東部,5,387,520,585,610,557,617,698,3974,224,328,414,482,498,601,752,3299
長野県,2001,佐久,1,977,1155,1123,1041,1055,1005,1194,7550,598,659,697,642,589,606,871,4662
長野県,2001,佐久,2,1432,1551,1526,1248,1121,915,969,8762,1306,1477,1373,1287,1148,1041,1004,8636
長野県,2001,佐久,3,556,555,523,522,442,318,346,3262,527,577,601,509,513,478,489,3694
長野県,2001,佐久,4,443,476,415,366,276,259,218,2453,344,368,388,364,346,343,377,2530
長野県,2001,佐久,5,469,616,643,673,631,629,798,4459,257,398,476,480,521,658,967,3757
長野県,2002,上小,1,898,1053,1074,867,806,716,847,6261,529,672,619,523,508,440,604,3895
長野県,2002,上小,2,1170,1525,1384,1144,966,779,703,7671,1015,1329,1264,1103,988,842,884,7425
長野県,2002,上小,3,546,643,550,492,363,281,250,3125,464,552,602,492,411,322,341,3184
長野県,2002,上小,4,394,510,387,351,291,239,238,2410,291,381,375,360,333,329,371,2440
長野県,2002,上小,5,425,650,695,610,516,549,677,4122,232,348,434,447,479,648,920,3508
長野県,2003,諏訪,1,1193,1450,1337,1003,877,759,1061,7680,666,943,790,622,576,594,981,5172
長野県,2003,諏訪,2,1084,1375,1375,1040,820,689,737,7120,1084,1447,1346,1045,925,840,907,7594
長野県,2003,諏訪,3,432,546,523,462,348,275,339,2925,462,612,590,483,404,338,513,3402
長野県,2003,諏訪,4,385,491,461,392,255,247,232,2463,283,416,470,398,322,291,396,2576
長野県,2003,諏訪,5,443,668,716,637,556,562,738,4320,238,390,518,478,525,593,890,3632
長野県,2004,上伊那,1,1270,1611,1369,1069,1054,878,1101,8352,746,958,797,691,585,627,876,5280
長野県,2004,上伊那,2,1126,1360,1324,1094,960,783,715,7362,1123,1449,1303,1099,979,844,886,7683
長野県,2004,上伊那,3,431,527,473,434,386,305,354,2910,462,551,579,490,451,435,474,3442
長野県,2004,上伊那,4,387,499,396,374,279,227,279,2441,303,385,419,354,340,314,393,2508
長野県,2004,上伊那,5,462,623,676,616,570,546,792,4285,228,361,488,473,515,654,1086,3805
長野県,2005,飯伊,1,1125,1279,1240,1075,969,955,1020,7663,624,797,673,664,695,650,723,4826
長野県,2005,飯伊,2,940,1058,1062,942,748,684,622,6056,906,1066,1016,964,815,750,673,6190
長野県,2005,飯伊,3,367,389,415,326,332,289,263,2381,408,472,455,387,384,330,364,2800
長野県,2005,飯伊,4,332,392,315,309,251,181,154,1934,292,348,376,335,331,252,202,2136
長野県,2005,飯伊,5,357,481,487,502,389,422,453,3091,178,264,353,393,399,518,574,2679
長野県,2006,木曽,1,128,151,175,175,182,216,310,1337,71,85,80,93,109,142,215,795
長野県,2006,木曽,2,123,164,152,176,149,160,177,1101,124,115,148,148,152,150,197,1034
長野県,2006,木曽,3,55,86,76,80,67,73,75,512,67,60,65,69,80,66,89,496
長野県,2006,木曽,4,48,58,43,59,37,57,38,340,35,42,52,54,59,63,88,393
長野県,2006,木曽,5,43,64,83,99,62,80,134,565,21,31,48,63,66,94,161,484
長野県,2007,松本,1,2433,2951,2849,2386,1898,1524,1627,15668,1366,1827,1764,1484,1252,1067,1304,10064
長野県,2007,松本,2,2750,3233,3013,2275,1688,1202,1030,15191,2190,2813,2568,1986,1622,1116,1042,13337
長野県,2007,松本,3,1318,1499,1447,1201,886,660,525,7536,1243,1604,1554,1220,948,684,705,7958
長野県,2007,松本,4,923,1194,1086,789,538,396,339,5265,712,867,867,776,629,458,439,4748
長野県,2007,松本,5,1027,1497,1504,1427,1131,887,942,8415,546,755,998,995,877,998,1168,6337
長野県,2008,大北,1,301,370,373,318,299,307,411,2379,151,240,218,230,202,166,280,1487
長野県,2008,大北,2,278,400,381,373,303,253,278,2266,257,399,408,355,320,281,282,2302
長野県,2008,大北,3,145,169,184,172,153,132,128,1083,130,169,176,173,138,142,151,1079
長野県,2008,大北,4,130,150,129,115,91,61,92,768,97,125,109,103,109,96,119,758
長野県,2008,大北,5,129,180,196,194,174,189,257,1319,88,110,156,181,171,202,333,1241
長野県,2009,長野,1,2740,3390,3238,2703,2431,2159,2846,19507,1590,2006,1909,1656,1494,1665,2669,12989
長野県,2009,長野,2,3923,4512,4441,3632,2912,2275,2295,23990,3445,4364,4210,3550,2856,2466,2930,23821
長野県,2009,長野,3,1707,2033,1928,1492,1210,901,958,10229,1496,1964,1958,1593,1292,1173,1377,10853
長野県,2009,長野,4,1179,1472,1305,1070,864,638,637,7165,839,1117,1186,1008,874,878,902,6804
長野県,2009,長野,5,1288,1891,2005,1968,1699,1524,2008,12383,617,1051,1249,1367,1335,1789,2638,10046
長野県,2010,北信,1,418,521,510,501,521,571,710,3752,296,353,393,362,354,386,489,2633
長野県,2010,北信,2,540,684,642,626,497,497,479,3965,575,708,618,636,596,471,506,4110
長野県,2010,北信,3,244,254,233,189,190,163,156,1429,216,277,242,259,213,224,187,1618
長野県,2010,北信,4,158,169,166,160,146,102,94,995,105,123,135,139,164,161,149,976
長野県,2010,北信,5,160,160,201,229,229,190,268,1437,76,151,153,192,200,262,315,1349
岐阜県,2101,岐阜,1,4545,5735,5552,4494,3498,2618,2820,29262,2419,3164,3011,2407,2057,1698,2361,17117
岐阜県,2101,岐阜,2,4726,5548,5091,3859,2852,1757,1247,25080,4071,5032,4964,3743,2556,1618,1314,23298
岐阜県,2101,岐阜,3,1674,2047,1970,1525,1207,1001,1308,10732,1631,2166,2197,1769,1527,1597,2186,13073
岐阜県,2101,岐阜,4,1685,1924,1659,1323,883,521,385,8380,1092,1381,1416,1115,818,445,366,6633
岐阜県,2101,岐阜,5,1859,2753,2938,2539,2017,1287,1192,14585,833,1302,1578,1475,1198,863,1017,8266
岐阜県,2102,西濃,1,2172,2793,2660,2167,2013,1612,1856,15273,1164,1494,1388,1218,1243,1097,1617,9221
岐阜県,2102,西濃,2,2169,2558,2371,1884,1490,1196,1127,12795,1802,2324,2127,1924,1569,1277,1369,12392
岐阜県,2102,西濃,3,761,868,850,650,536,361,363,4389,682,873,880,744,617,549,524,4869
岐阜県,2102,西濃,4,707,943,758,687,484,372,349,4300,501,655,704,588,501,464,458,3871
岐阜県,2102,西濃,5,960,1253,1342,1258,1050,864,970,7697,401,577,770,743,711,775,1164,5141
岐阜県,2103,中濃,1,2354,2834,2629,2162,2181,2045,2545,16750,1067,1461,1410,1279,1390,1459,1957,10023
岐阜県,2103,中濃,2,2219,2528,2317,1949,1587,1330,1281,13211,1857,2237,2168,1913,1741,1487,1408,12811
岐阜県,2103,中濃,3,735,937,841,625,592,541,530,4801,739,904,905,849,725,719,721,5562
岐阜県,2103,中濃,4,795,937,847,598,557,434,404,4572,525,733,747,650,595,554,578,4382
岐阜県,2103,中濃,5,888,1275,1233,1179,1107,1052,1294,8028,437,620,759,770,852,1086,1422,5946
岐阜県,2104,東濃,1,2140,2696,2626,2302,2092,1801,2028,15685,1039,1414,1432,1327,1319,1259,1716,9506
岐阜県,2104,東濃,2,1775,2165,2041,1686,1432,1139,1177,11415,1550,1972,1955,1682,1597,1351,1640,11747
岐阜県,2104,東濃,3,712,827,790,709,554,460,412,4464,660,814,873,740,676,579,649,4991
岐阜県,2104,東濃,4,804,978,792,698,540,437,379,4628,583,769,809,734,592,523,558,4568
岐阜県,2104,東濃,5,777,1050,1134,1138,956,917,1059,7031,413,552,696,801,841,947,1320,5570
岐阜県,2105,飛騨,1,847,1010,986,948,829,596,577,5793,443,617,616,594,487,380,397,3534
岐阜県,2105,飛騨,2,770,944,885,754,653,378,305,4689,775,925,942,778,630,382,318,4750
岐阜県,2105,飛騨,3,264,332,315,256,199,122,120,1608,282,387,362,347,254,157,139,1928
岐阜県,2105,飛騨,4,319,401,343,281,221,97,78,1740,260,320,317,276,222,139,113,1647
岐阜県,2105,飛騨,5,312,448,464,414,358,217,189,2402,163,248,304,320,232,251,248,1766
静岡県,2201,賀茂,1,228,297,367,299,301,265,419,2176,101,169,145,160,176,217,326,1294
静岡県,2201,賀茂,2,189,250,278,250,237,240,232,1676,171,238,294,235,248,267,316,1769
静岡県,2201,賀茂,3,131,156,207,170,135,104,95,998,110,167,162,146,129,138,157,1009
静岡県,2201,賀茂,4,49,101,99,101,66,80,68,564,69,80,120,83,70,90,111,623
静岡県,2201,賀茂,5,66,112,128,124,104,142,175,851,36,71,81,91,95,148,269,791
静岡県,2202,熱海伊東,1,264,400,437,383,429,420,733,3066,184,273,304,277,295,387,856,2576
静岡県,2202,熱海伊東,2,312,487,531,490,439,365,474,3098,349,486,557,501,468,475,755,3591
静岡県,2202,熱海伊東,3,131,189,227,181,169,151,213,1261,131,208,234,212,206,212,329,1532
静岡県,2202,熱海伊東,4,107,171,159,141,150,126,170,1024,93,137,175,161,144,163,252,1125
静岡県,2202,熱海伊東,5,114,198,258,244,228,253,432,1727,79,110,178,179,222,313,544,1625
静岡県,2203,駿東田方,1,3225,3955,3908,3212,2693,2089,2358,21440,1622,2080,2025,1802,1560,1507,2086,12682
静岡県,2203,駿東田方,2,4142,4897,4630,3761,2840,2038,1776,24084,3521,4561,4312,3535,2710,2145,2259,23043
静岡県,2203,駿東田方,3,1790,2121,1999,1664,1294,886,717,10471,1572,2003,1980,1618,1325,986,1053,10537
静岡県,2203,駿東田方,4,1254,1496,1472,1130,846,516,509,7223,907,1133,1188,1067,795,648,652,6390
静岡県,2203,駿東田方,5,1574,2251,2431,2290,1865,1348,1466,13225,784,1164,1509,1370,1229,1215,1623,8894
静岡県,2204,富士,1,2314,2855,2836,2359,2045,1627,1893,15929,1068,1416,1373,1226,1077,1068,1719,8947
静岡県,2204,富士,2,2609,2952,2848,2315,1758,1253,1239,14974,2055,2561,2547,2099,1684,1427,1476,13849
静岡県,2204,富士,3,1123,1224,1311,992,757,599,653,6659,976,1274,1302,1085,882,850,867,7236
静岡県,2204,富士,4,827,1034,929,769,590,410,384,4943,571,713,841,755,585,497,490,4452
静岡県,2204,富士,5,1005,1401,1483,1395,1130,1014,1142,8570,431,682,851,816,822,906,1231,5739
静岡県,2205,静岡,1,3458,4362,4369,3577,3170,2580,3298,24814,1979,2466,2401,1955,1826,1731,2686,15044
静岡県,2205,静岡,2,4506,5463,5535,4200,3337,2487,2410,27938,3997,5082,5162,4000,3113,2398,2780,26532
静岡県,2205,静岡,3,1992,2473,2322,1913,1479,1061,984,12224,1865,2295,2286,1943,1599,1246,1233,12467
静岡県,2205,静岡,4,1460,1846,1671,1426,1127,763,776,9069,1167,1499,1643,1343,1060,925,926,8563
静岡県,2205,静岡,5,1771,2754,3107,2812,2358,1945,2328,17075,1081,1503,1906,1933,1778,1857,2394,12452
静岡県,2206,志太榛原,1,2517,3039,2764,2401,2247,1847,2113,16928,1323,1598,1564,1297,1269,1183,1697,9931
静岡県,2206,志太榛原,2,2875,3367,3103,2521,2048,1417,1208,16539,2706,3123,2903,2430,2066,1437,1365,16030
静岡県,2206,志太榛原,3,1297,1464,1367,1157,1000,734,668,7687,1187,1495,1369,1210,1050,905,882,8098
静岡県,2206,志太榛原,4,990,1138,983,815,675,487,388,5476,739,953,891,814,719,627,609,5352
静岡県,2206,志太榛原,5,1139,1634,1742,1573,1467,1240,1549,10344,591,861,1007,1033,1096,1201,1657,7446
静岡県,2207,中東遠,1,3101,3373,2848,2334,2189,1836,2113,17794,1398,1577,1429,1135,1250,1195,1598,9582
静岡県,2207,中東遠,2,3542,3846,3238,2468,2166,1620,1392,18272,3142,3562,3030,2384,2211,1831,1746,17906
静岡県,2207,中東遠,3,1464,1670,1468,1223,1099,768,663,8355,1357,1550,1391,1214,1117,940,863,8432
静岡県,2207,中東遠,4,1130,1203,1036,931,761,566,532,6159,880,1034,968,866,872,765,736,6121
静岡県,2207,中東遠,5,1535,2033,1973,1953,1790,1625,2008,12917,732,1082,1248,1307,1417,1655,2112,9553
静岡県,2208,西部,1,5025,5696,5283,4398,3792,2961,3476,30631,2513,3020,2983,2312,2222,2040,2877,17967
静岡県,2208,西部,2,5914,6635,6140,4695,3650,2747,2782,32563,5303,6352,5789,4515,3625,3036,3094,31714
静岡県,2208,西部,3,3091,3419,3325,2725,2185,1460,1263,17468,2738,3207,3233,2540,2135,1679,1649,17181
静岡県,2208,西部,4,1881,2100,1888,1543,1275,873,845,10405,1403,1748,1871,1486,1287,1059,1106,9960
静岡県,2208,西部,5,2692,3778,4193,3919,3379,2677,3038,23676,1335,2090,2766,2593,2469,2341,3099,16693
愛知県,2302,海部,1,1871,2508,2565,2041,1573,1273,1880,13711,905,1223,1258,1078,917,995,1970,8346
愛知県,2302,海部,2,1964,2551,2518,1824,1208,958,1172,12195,1551,2175,2126,1567,1331,1280,1648,11678
愛知県,2302,海部,3,728,1018,928,642,467,386,387,4556,632,898,851,615,481,440,595,4512
愛知県,2302,海部,4,529,765,699,488,361,265,296,3403,399,546,577,452,331,309,431,3045
愛知県,2302,海部,5,648,1064,1126,916,710,608,829,5901,311,537,607,551,534,618,1204,4362
愛知県,2304,尾張東部,1,2572,3452,3275,2436,1940,1600,2313,17588,1491,1868,1790,1417,1211,1276,2213,11266
愛知県,2304,尾張東部,2,3124,3781,3547,2643,1808,1317,1682,17902,2954,3604,3424,2435,1803,1673,2359,18252
愛知県,2304,尾張東部,3,1801,1834,1704,1259,927,580,711,8816,1352,1522,1470,1111,865,821,1182,8323
愛知県,2304,尾張東部,4,1187,1286,1233,823,628,360,436,5953,813,960,983,745,605,474,537,5117
愛知県,2304,尾張東部,5,1669,2037,2258,1902,1467,1036,1304,11673,749,956,1147,1072,900,1003,1548,7375
愛知県,2305,尾張西部,1,2788,3855,3877,3105,2464,2198,3275,21562,1671,2229,2308,1909,1740,1920,3867,15644
愛知県,2305,尾張西部,2,3232,4041,3921,2929,2100,1691,1972,19886,3008,3870,3777,3027,2261,2076,2606,20625
愛知県,2305,尾張西部,3,1255,1627,1509,1213,856,710,853,8023,1168,1593,1628,1231,993,972,1210,8795
愛知県,2305,尾張西部,4,1029,1284,1148,958,557,470,544,5990,721,950,1013,819,591,647,752,5493
愛知県,2305,尾張西部,5,1189,1797,1886,1670,1308,1132,1504,10486,592,1016,1180,1093,1036,1116,1802,7835
愛知県,2306,尾張北部,1,4116,5410,5192,3916,2912,2432,3233,27211,2047,2728,2592,1938,1669,1788,3215,15977
愛知県,2306,尾張北部,2,4322,5330,5254,3819,2625,1967,2317,25634,3689,4858,4652,3369,2550,2334,3259,24711
愛知県,2306,尾張北部,3,1811,2212,2059,1592,1045,864,968,10551,1468,1992,1987,1452,1161,1207,1637,10904
愛知県,2306,尾張北部,4,1592,1910,1634,1217,841,588,621,8403,1041,1381,1371,1058,733,746,930,7260
愛知県,2306,尾張北部,5,1686,2626,2789,2312,1823,1484,2061,14781,863,1302,1619,1466,1212,1504,2326,10292
愛知県,2307,知多半島,1,4317,5587,5169,4206,3350,2958,4665,30252,2163,2782,2847,2394,2245,2600,4914,19945
愛知県,2307,知多半島,2,4480,5097,4458,3443,2513,1981,2042,24014,3894,4578,4304,3413,2605,2349,2851,23994
愛知県,2307,知多半島,3,1757,2062,1882,1487,1038,695,655,9576,1427,1850,1667,1223,1021,871,982,9041
愛知県,2307,知多半島,4,1438,1733,1429,1031,769,551,625,7576,1075,1298,1304,962,775,796,883,7093
愛知県,2307,知多半島,5,1683,2386,2469,2097,1660,1563,2172,14030,859,1285,1394,1329,1267,1513,2384,10031
愛知県,2308,西三河北部,1,2747,3186,3065,2276,1913,1749,2877,17813,1389,1804,1734,1456,1382,1828,3252,12845
愛知県,2308,西三河北部,2,3121,3493,3194,2325,1574,1030,888,15625,2655,3169,3126,2120,1593,1127,1142,14932
愛知県,2308,西三河北部,3,2867,2932,2865,2351,1588,579,507,13689,1681,1874,1755,1316,880,713,769,8988
愛知県,2308,西三河北部,4,1160,1305,1071,762,568,407,370,5643,809,1071,1008,736,575,480,509,5188
愛知県,2308,西三河北部,5,2455,2919,3390,3145,2279,1334,1620,17142,1011,1370,1566,1272,1013,1083,1382,8697
愛知県,2309,西三河南部西,1,4992,5868,5488,4356,3329,2678,3655,30366,2406,2998,3045,2475,2017,2153,3384,18478
愛知県,2309,西三河南部西,2,5964,6225,5682,4233,2853,1858,1895,28710,4483,5178,4953,3919,2679,2177,2422,25811
愛知県,2309,西三河南部西,3,2332,2466,2279,1729,1213,746,741,11506,1695,1915,1866,1458,997,900,1009,9840
愛知県,2309,西三河南部西,4,1439,1661,1420,1094,802,622,648,7686,1082,1292,1282,1029,781,695,739,6900
愛知県,2309,西三河南部西,5,1860,2497,2613,2245,1790,1487,1985,14477,834,1261,1437,1378,1207,1401,1885,9403
愛知県,2310,西三河南部東,1,2986,3527,3260,2561,2139,2198,3280,19951,1608,2019,1852,1726,1713,1933,3010,13861
愛知県,2310,西三河南部東,2,3125,3265,2917,2099,1556,1295,1401,15658,2716,2892,2680,2140,1715,1491,1700,15334
愛知県,2310,西三河南部東,3,1438,1482,1318,1033,729,547,574,7121,1062,1254,1199,898,746,784,922,6865
愛知県,2310,西三河南部東,4,1022,1076,881,686,509,434,368,4976,755,898,909,769,670,574,609,5184
愛知県,2310,西三河南部東,5,1292,1534,1592,1370,1286,1070,1364,9508,645,881,958,913,888,1001,1444,6730
愛知県,2311,東三河北部,1,269,315,270,273,272,297,415,2111,114,145,140,136,185,214,355,1289
愛知県,2311,東三河北部,2,311,332,339,270,257,272,279,2060,228,268,250,267,281,318,309,1921
愛知県,2311,東三河北部,3,133,155,137,123,142,108,119,917,98,129,120,120,151,133,181,932
愛知県,2311,東三河北部,4,102,113,93,85,74,69,89,625,63,101,96,78,80,95,114,627
愛知県,2311,東三河北部,5,114,145,162,160,164,159,248,1152,49,89,86,107,140,189,316,976
愛知県,2312,東三河南部,1,3938,4896,4408,3504,3117,2638,3195,25696,1869,2486,2307,2010,1964,1808,2864,15308
愛知県,2312,東三河南部,2,4026,4607,4149,3196,2608,1765,1804,22155,3367,3946,3898,3192,2620,2148,2440,21611
愛知県,2312,東三河南部,3,2111,2238,2186,1716,1201,839,879,11170,1512,1887,1831,1535,1296,1197,1394,10652
愛知県,2312,東三河南部,4,1338,1549,1405,1100,777,637,702,7508,957,1158,1276,984,920,855,982,7132
愛知県,2312,東三河南部,5,1759,2289,2471,2163,1826,1602,1876,13986,768,1171,1432,1358,1336,1556,2385,10006
愛知県,2313,名古屋・尾張中部,1,13413,15754,15568,12523,9633,7311,8677,82879,7510,8835,8688,7187,5942,5150,7532,50844
愛知県,2313,名古屋・尾張中部,2,16615,18441,17405,13245,9448,6296,6383,87833,14029,16226,15517,11990,8693,6814,8163,81432
愛知県,2313,名古屋・尾張中部,3,6934,7643,7070,5573,3879,2479,2242,35820,6153,7032,6836,5173,3720,2793,3218,34925
愛知県,2313,名古屋・尾張中部,4,6016,6705,6046,4570,3102,1984,1895,30318,3878,4689,4646,3687,2689,2178,2391,24158
愛知県,2313,名古屋・尾張中部,5,7198,9454,10069,8739,6739,4908,5763,52870,3410,4653,5545,4977,4319,4293,6068,33265
三重県,2401,北勢,1,5201,6493,6537,5254,4065,3450,4902,35902,2615,3539,3362,2816,2569,2793,4912,22606
三重県,2401,北勢,2,5068,6285,5890,4621,3490,2677,2902,30933,4750,5695,5621,4577,3563,3216,3944,31366
三重県,2401,北勢,3,2089,2424,2305,1786,1544,1234,1530,12912,1865,2426,2407,1840,1521,1711,2337,14107
三重県,2401,北勢,4,1763,2233,2016,1469,1173,782,837,10273,1219,1688,1666,1329,1038,987,1218,9145
三重県,2401,北勢,5,2493,3600,3753,3390,2706,2195,3010,21147,1126,1714,2155,2053,1945,2208,3361,14562
三重県,2402,中勢伊賀,1,2617,3094,2896,2374,2303,1930,2481,17695,1372,1757,1674,1447,1438,1503,2393,11584
三重県,2402,中勢伊賀,2,2731,3140,3006,2383,2117,1774,1732,16883,2433,2904,2759,2340,2112,1898,2104,16550
三重県,2402,中勢伊賀,3,1022,1138,1060,861,762,717,811,6371,948,1101,1088,931,939,995,1226,7228
三重県,2402,中勢伊賀,4,787,963,857,742,588,451,466,4854,617,739,735,648,588,540,650,4517
三重県,2402,中勢伊賀,5,984,1457,1565,1408,1278,1221,1481,9394,531,814,1011,1012,1102,1269,1756,7495
三重県,2403,南勢志摩,1,2477,3115,2884,2603,2401,2253,3029,18762,1411,1831,1738,1628,1592,1908,3052,13160
三重県,2403,南勢志摩,2,2401,2809,2838,2478,2124,1738,1908,16296,2231,2894,2908,2566,2377,2282,2625,17883
三重県,2403,南勢志摩,3,907,1104,1025,944,817,787,961,6545,846,1114,1156,1082,996,1182,1422,7798
三重県,2403,南勢志摩,4,686,968,861,699,557,488,480,4739,520,676,729,648,587,654,713,4527
三重県,2403,南勢志摩,5,855,1323,1456,1343,1115,1123,1521,8736,448,755,831,842,955,1262,1920,7013
三重県,2404,東紀州,1,261,370,393,372,345,390,574,2705,151,191,210,225,252,273,548,1850
三重県,2404,東紀州,2,279,345,330,291,299,312,331,2187,218,327,306,334,349,394,532,2460
三重県,2404,東紀州,3,107,135,141,148,125,140,176,972,109,138,157,158,191,194,292,1239
三重県,2404,東紀州,4,67,123,81,87,82,60,60,560,66,71,96,73,91,113,121,631
三重県,2404,東紀州,5,90,160,179,158,132,200,219,1138,48,77,99,116,123,194,297,954
滋賀県,2501,大津,1,1710,2089,1968,1636,1380,1192,1469,11444,1146,1293,1318,1104,955,885,1387,8088
滋賀県,2501,大津,2,1997,2320,2141,1705,1382,1116,1171,11832,2003,2370,2232,1750,1530,1262,1567,12714
滋賀県,2501,大津,3,749,875,771,649,529,393,405,4371,801,871,894,763,596,512,508,4945
滋賀県,2501,大津,4,574,697,632,537,419,338,389,3586,505,591,579,519,454,376,460,3484
滋賀県,2501,大津,5,694,1077,1125,1052,1002,866,1125,6941,391,639,763,780,794,779,1167,5313
滋賀県,2502,湖南,1,2325,2580,2273,1712,1235,952,1328,12405,1305,1503,1159,916,752,806,1356,7797
滋賀県,2502,湖南,2,2704,3080,2593,1927,1344,1049,1081,13778,2691,3021,2594,1800,1425,1195,1589,14315
滋賀県,2502,湖南,3,988,1105,933,727,461,359,407,4980,1055,1187,1084,738,520,473,567,5624
滋賀県,2502,湖南,4,714,811,676,533,358,304,349,3745,543,664,616,421,355,383,459,3441
滋賀県,2502,湖南,5,893,1189,1271,1113,846,727,982,7021,518,764,827,666,625,706,1159,5265
滋賀県,2503,甲賀,1,962,1109,1005,826,738,661,900,6201,463,571,478,484,432,488,777,3693
滋賀県,2503,甲賀,2,1059,1209,1116,934,771,661,666,6416,942,1067,945,876,864,710,800,6204
滋賀県,2503,甲賀,3,429,453,391,317,323,201,211,2325,316,352,352,291,315,249,279,2154
滋賀県,2503,甲賀,4,260,290,241,195,172,169,190,1517,186,211,237,206,217,212,246,1515
滋賀県,2503,甲賀,5,271,388,446,391,392,380,541,2809,158,262,272,299,387,467,662,2507
滋賀県,2504,東近江,1,1459,1586,1381,1227,1046,880,1007,8586,736,832,784,722,657,609,870,5210
滋賀県,2504,東近江,2,1724,1796,1582,1277,1113,940,947,9379,1531,1689,1485,1351,1210,1103,1170,9539
滋賀県,2504,東近江,3,646,670,556,471,423,334,334,3434,575,584,570,506,460,369,408,3472
滋賀県,2504,東近江,4,415,444,359,305,268,225,266,2282,294,352,338,282,266,263,297,2092
滋賀県,2504,東近江,5,391,585,617,538,534,456,640,3761,266,387,413,452,511,604,744,3377
滋賀県,2505,湖東,1,919,1117,973,773,692,546,615,5635,491,612,576,477,442,380,493,3471
滋賀県,2505,湖東,2,1206,1285,1076,818,729,512,499,6125,996,1083,1015,833,738,643,606,5914
滋賀県,2505,湖東,3,364,394,357,294,228,207,161,2005,360,439,384,328,307,257,271,2346
滋賀県,2505,湖東,4,270,287,241,206,160,116,108,1388,173,247,212,165,189,160,173,1319
滋賀県,2505,湖東,5,300,391,410,369,329,313,369,2481,150,219,276,296,290,350,482,2063
滋賀県,2506,湖北,1,988,1152,1070,926,752,590,682,6160,533,647,588,510,488,458,595,3819
滋賀県,2506,湖北,2,1058,1189,1093,946,834,614,546,6280,1052,1138,1128,1057,889,763,711,6738
滋賀県,2506,湖北,3,300,382,371,304,253,211,194,2015,318,377,376,390,302,261,211,2235
滋賀県,2506,湖北,4,248,306,254,218,176,130,132,1464,202,240,263,212,195,170,188,1470
滋賀県,2506,湖北,5,299,385,391,384,320,340,418,2537,161,211,300,275,302,359,429,2037
滋賀県,2507,湖西,1,237,263,293,267,265,189,225,1739,120,159,193,183,176,161,220,1212
滋賀県,2507,湖西,2,228,271,285,271,269,157,154,1635,267,296,306,316,286,187,167,1825
滋賀県,2507,湖西,3,62,96,93,82,91,67,45,536,93,126,110,107,104,66,95,701
滋賀県,2507,湖西,4,57,62,77,63,77,47,35,418,57,67,89,79,79,74,60,505
滋賀県,2507,湖西,5,72,94,107,110,115,100,101,699,43,57,77,114,85,77,130,583
京都府,2601,丹後,1,467,666,664,662,654,554,662,4329,282,393,421,361,391,387,475,2710
京都府,2601,丹後,2,493,629,639,535,490,319,266,3371,435,604,613,569,460,292,230,3203
京都府,2601,丹後,3,175,224,222,206,175,159,132,1293,171,244,251,239,204,184,191,1484
京都府,2601,丹後,4,147,192,177,149,111,97,96,969,128,205,182,172,170,145,179,1181
京都府,2601,丹後,5,155,248,256,267,259,340,535,2060,121,194,244,273,336,506,724,2398
京都府,2602,中丹,1,1011,1341,1220,1056,955,837,1154,7574,523,730,672,583,642,608,1031,4789
京都府,2602,中丹,2,1099,1344,1207,1022,868,712,739,6991,920,1262,1126,945,899,723,932,6807
京都府,2602,中丹,3,354,445,380,314,297,266,289,2345,352,433,492,381,328,307,427,2720
京都府,2602,中丹,4,258,325,320,255,217,208,187,1770,230,284,286,224,267,206,248,1745
京都府,2602,中丹,5,293,428,454,406,409,371,591,2952,161,311,359,369,383,453,826,2862
京都府,2603,南丹,1,717,796,736,676,671,627,742,4965,355,459,417,404,425,365,557,2982
京都府,2603,南丹,2,750,871,757,626,571,497,525,4597,699,838,832,699,654,497,566,4785
京都府,2603,南丹,3,288,329,308,274,216,219,223,1857,275,377,346,305,289,274,323,2189
京都府,2603,南丹,4,205,238,199,179,179,136,175,1311,161,212,226,201,224,241,241,1506
京都府,2603,南丹,5,235,356,416,344,377,384,557,2669,146,210,285,335,387,461,727,2551
京都府,2604,京都・乙訓,1,6898,8922,8759,6932,5488,4118,5253,46370,4575,5610,5081,4176,3405,2922,4386,30155
京都府,2604,京都・乙訓,2,8870,10294,9423,7342,5396,3679,3740,48744,8578,9870,9347,7245,5213,3813,4430,48496
京都府,2604,京都・乙訓,3,3375,3921,3874,2903,2292,1596,1644,19605,3673,4298,4259,3332,2328,1872,2355,22117
京都府,2604,京都・乙訓,4,2898,3290,2999,2342,1776,1160,1026,15491,2329,2826,2859,2307,1772,1354,1501,14948
京都府,2604,京都・乙訓,5,3645,5153,5635,5043,4444,3149,3877,30946,2347,3343,3838,3662,3127,2981,4292,23590
京都府,2605,山城北,1,2229,2943,2757,2166,1684,1400,2248,15427,1258,1688,1445,1193,1025,1196,2303,10108
京都府,2605,山城北,2,2561,3379,2986,2117,1593,1367,1656,15659,2345,3031,2731,2071,1695,1797,2535,16205
京都府,2605,山城北,3,1065,1311,1188,878,698,632,775,6547,1031,1352,1275,1074,884,843,1387,7846
京都府,2605,山城北,4,744,1004,841,645,513,417,501,4665,567,754,812,646,559,541,825,4704
京都府,2605,山城北,5,823,1383,1427,1309,1086,1036,1525,8589,504,803,908,893,853,1088,1884,6933
京都府,2606,山城南,1,631,754,698,553,404,423,636,4099,356,449,373,310,273,290,496,2547
京都府,2606,山城南,2,801,900,811,611,493,365,446,4427,693,822,746,594,478,445,591,4369
京都府,2606,山城南,3,277,342,316,226,225,194,214,1794,342,395,344,295,220,256,312,2164
京都府,2606,山城南,4,252,323,280,192,168,139,137,1491,162,239,229,182,169,165,233,1379
京都府,2606,山城南,5,277,425,447,383,344,297,417,2590,145,219,241,268,269,322,492,1956
大阪府,2701,豊能,1,4617,5652,5624,4350,3264,2432,3246,29185,2781,3516,3605,2644,1961,1879,3070,19456
大阪府,2701,豊能,2,6372,7101,6663,4895,3471,2191,2318,33011,5642,6697,6298,4722,3102,2317,2855,31633
大阪府,2701,豊能,3,2657,2912,2952,2186,1531,1041,994,14273,2655,3116,3087,2235,1582,1244,1544,15463
大阪府,2701,豊能,4,2130,2576,2323,1706,1227,795,783,11540,1563,1915,1998,1429,1045,908,1157,10015
大阪府,2701,豊能,5,2352,3419,3774,3420,2497,1823,2400,19685,1242,1809,2248,2024,1662,1726,2507,13218
大阪府,2702,三島,1,3450,4621,4328,3148,2513,1881,2615,22556,2207,2670,2452,1756,1508,1518,2705,14816
大阪府,2702,三島,2,4159,4977,4800,3246,2344,1580,1447,22553,3789,4683,4366,2874,2261,1578,1921,21472
大阪府,2702,三島,3,1737,2079,1877,1360,1050,755,902,9760,1726,2120,2016,1500,1165,1111,1421,11059
大阪府,2702,三島,4,1448,1729,1572,1149,797,534,540,7769,1091,1492,1458,1054,755,717,713,7280
大阪府,2702,三島,5,1642,2443,2748,2238,1724,1410,2003,14208,887,1339,1717,1529,1266,1357,2094,10189
大阪府,2703,北河内,1,4595,6291,6231,4677,3394,1943,1622,28753,2444,3467,3288,2416,1640,993,1110,15358
大阪府,2703,北河内,2,5490,6779,6546,4925,3447,1854,1290,30331,4784,6068,6022,4283,2604,1421,1173,26355
大阪府,2703,北河内,3,2024,2721,2534,1961,1368,815,634,12057,1898,2615,2644,1855,1149,692,665,11518
大阪府,2703,北河内,4,1737,2061,2043,1544,1040,595,422,9442,1192,1570,1675,1301,819,484,488,7529
大阪府,2703,北河内,5,1719,2766,3072,2619,1950,1256,1059,14441,945,1452,1895,1648,1218,896,1039,9093
大阪府,2704,中河内,1,3343,4627,4644,3520,2629,1644,1874,22281,1907,2591,2679,2190,1652,1370,1718,14107
大阪府,2704,中河内,2,3893,4719,4833,3533,2495,1512,1429,22414,3248,4340,4477,3430,2385,1635,1885,21400
大阪府,2704,中河内,3,1427,1736,1712,1410,915,585,517,8302,1241,1800,1777,1400,909,625,672,8424
大阪府,2704,中河内,4,1204,1566,1485,1108,763,454,417,6997,866,1171,1214,1038,722,487,587,6085
大阪府,2704,中河内,5,1227,1952,2271,1927,1453,1000,1078,10908,626,1082,1344,1227,1013,950,1207,7449
大阪府,2705,南河内,1,1929,2687,2798,2413,1988,1501,1823,15139,1088,1574,1549,1325,1093,1024,1628,9281
大阪府,2705,南河内,2,2345,3075,3110,2561,2030,1453,1460,16034,2181,2819,3077,2458,1801,1437,1758,15531
大阪府,2705,南河内,3,835,1137,1148,918,772,507,463,5780,850,1132,1213,970,775,580,655,6175
大阪府,2705,南河内,4,762,916,933,798,621,470,443,4943,552,769,826,689,563,510,540,4449
大阪府,2705,南河内,5,797,1169,1487,1359,1263,1082,1206,8363,441,708,887,895,845,942,1219,5937
大阪府,2706,堺市,1,3336,4778,4688,3421,2549,1957,2905,23634,2121,2701,2438,1902,1536,1659,3039,15396
大阪府,2706,堺市,2,4253,5581,5295,3677,2710,1979,2201,25696,4125,5267,5110,3602,2688,2329,3205,26326
大阪府,2706,堺市,3,1570,1994,1883,1452,1094,754,831,9578,1628,2086,2050,1536,1086,949,1243,10578
大阪府,2706,堺市,4,1349,1675,1585,1165,793,546,625,7738,972,1345,1284,1037,767,699,894,6998
大阪府,2706,堺市,5,1454,2333,2459,2094,1593,1341,1752,13026,747,1277,1468,1413,1130,1386,2239,9660
大阪府,2707,泉州,1,3446,4809,4953,3748,2927,2238,2806,24927,1910,2611,2617,2026,1627,1591,2512,14894
大阪府,2707,泉州,2,4189,5370,5256,4051,2852,2106,2141,25965,3832,5144,4996,3922,2823,2362,2733,25812
大阪府,2707,泉州,3,1474,2002,1923,1519,1140,836,759,9653,1562,2053,2080,1551,1173,974,1094,10487
大阪府,2707,泉州,4,1180,1508,1515,1115,839,603,611,7371,881,1248,1369,1029,877,741,835,6980
大阪府,2707,泉州,5,1233,2008,2364,2131,1794,1609,2048,13187,796,1259,1578,1459,1333,1732,2355,10512
大阪府,2708,大阪市,1,12530,15260,15399,11834,8589,5030,4045,72687,7973,9089,9011,7388,5225,2871,2852,44409
大阪府,2708,大阪市,2,17244,19088,17997,13051,8769,4908,3282,84339,17578,19810,18795,14307,9076,4103,2976,86645
大阪府,2708,大阪市,3,6741,7335,6970,5304,3517,1933,1179,32979,6849,7747,7518,5701,3500,1748,1297,34360
大阪府,2708,大阪市,4,5600,6476,5886,4308,2802,1464,938,27474,4562,5483,5256,4125,2559,1302,901,24188
大阪府,2708,大阪市,5,6200,8515,9526,7892,5801,3209,2549,43692,3770,5094,5634,5007,3582,2434,2321,27842
兵庫県,2801,神戸,1,7117,9184,9022,7184,5936,4693,5889,49025,4462,5455,5210,4165,3617,3349,5024,31282
兵庫県,2801,神戸,2,8905,10586,10180,7688,5951,4435,4559,52304,8518,10176,9801,7873,6144,4757,5974,53243
兵庫県,2801,神戸,3,3291,3880,3634,2978,2487,1827,2059,20156,3408,4219,4049,3266,2766,2540,2998,23246
兵庫県,2801,神戸,4,2804,3443,3180,2501,2001,1454,1405,16788,2182,2824,2802,2383,1936,1651,1934,15712
兵庫県,2801,神戸,5,3519,4955,5648,5212,4665,3826,4546,32371,1966,2939,3447,3427,3312,3448,4900,23439
兵庫県,2804,東播磨,1,3941,4814,4637,3528,2762,2360,2818,24860,1814,2322,2231,1694,1385,1484,2291,13221
兵庫県,2804,東播磨,2,4345,4942,4562,3358,2606,1705,1649,23167,3805,4525,4367,3188,2386,1856,2100,22227
兵庫県,2804,東播磨,3,1561,1711,1674,1312,1013,887,930,9088,1424,1795,1747,1476,1177,1210,1523,10352
兵庫県,2804,東播磨,4,1268,1559,1399,1046,825,578,566,7241,910,1129,1160,875,712,737,773,6296
兵庫県,2804,東播磨,5,1595,2242,2372,2078,1803,1592,2014,13696,766,1142,1347,1290,1236,1418,2160,9359
兵庫県,2805,北播磨,1,1360,1677,1598,1422,1250,1116,1393,9816,711,908,865,794,715,805,1081,5879
兵庫県,2805,北播磨,2,1292,1593,1564,1257,1066,836,820,8428,1226,1569,1504,1304,1175,954,962,8694
兵庫県,2805,北播磨,3,499,574,522,470,360,302,259,2986,443,543,559,488,434,393,366,3226
兵庫県,2805,北播磨,4,382,451,402,356,300,221,175,2287,284,365,393,347,334,268,306,2297
兵庫県,2805,北播磨,5,453,648,664,626,534,531,691,4147,249,356,439,439,461,524,774,3242
兵庫県,2808,但馬,1,875,1052,1023,928,1006,1030,1272,7186,490,648,670,660,710,746,962,4886
兵庫県,2808,但馬,2,1004,1200,1045,971,909,786,698,6613,857,1130,1142,1050,1008,834,839,6860
兵庫県,2808,但馬,3,282,342,340,292,265,206,215,1942,302,369,400,360,343,318,297,2389
兵庫県,2808,但馬,4,268,343,288,224,277,216,197,1813,231,295,329,281,324,358,300,2118
兵庫県,2808,但馬,5,273,406,397,362,410,451,640,2939,162,258,285,357,388,558,765,2773
兵庫県,2809,丹波,1,530,587,566,495,527,475,585,3765,267,343,337,315,373,322,408,2365
兵庫県,2809,丹波,2,554,689,567,467,477,408,379,3541,504,577,551,536,544,452,422,3586
兵庫県,2809,丹波,3,179,201,183,141,147,143,149,1143,168,202,188,201,184,181,186,1310
兵庫県,2809,丹波,4,159,182,120,153,121,115,100,950,132,160,175,141,158,161,166,1093
兵庫県,2809,丹波,5,160,200,235,214,253,230,265,1557,87,117,159,187,213,260,333,1356
兵庫県,2810,淡路,1,591,781,710,669,704,765,922,5142,395,461,447,418,507,550,781,3559
兵庫県,2810,淡路,2,639,742,674,627,550,479,453,4164,656,797,774,678,728,624,655,4912
兵庫県,2810,淡路,3,217,244,239,227,219,172,200,1518,245,281,268,257,263,288,301,1903
兵庫県,2810,淡路,4,133,156,164,128,140,122,110,953,150,193,194,166,193,182,157,1235
兵庫県,2810,淡路,5,181,245,255,226,267,315,410,1899,108,171,168,206,262,364,474,1753
兵庫県,2811,阪神,1,7214,9739,9725,7590,5634,4130,5085,49117,4424,5678,5529,4223,3435,2882,4444,30615
兵庫県,2811,阪神,2,9382,11450,11270,8476,6125,4095,3888,54686,9033,11377,11176,8262,5910,4157,4821,54736
兵庫県,2811,阪神,3,3785,4615,4496,3730,2567,1576,1484,22253,3622,4660,4805,3521,2419,1797,1878,22702
兵庫県,2811,阪神,4,2972,3813,3630,2890,1998,1308,1251,17862,2359,3094,3253,2487,1797,1419,1534,15943
兵庫県,2811,阪神,5,3426,5252,6338,5695,4544,3291,3931,32477,1921,3022,3783,3554,2897,2870,4162,22209
兵庫県,2812,播磨姫路,1,4211,5379,4975,4224,3583,3128,4345,29845,2024,2625,2448,2149,1927,2210,3914,17297
兵庫県,2812,播磨姫路,2,4558,5445,4832,3995,3210,2492,2572,27104,4047,5223,4871,3946,3351,3083,3669,28190
兵庫県,2812,播磨姫路,3,1671,1876,1699,1499,1215,992,882,9834,1559,1992,1870,1569,1387,1289,1460,11126
兵庫県,2812,播磨姫路,4,1447,1753,1527,1132,982,683,665,8189,993,1364,1244,1133,967,875,960,7536
兵庫県,2812,播磨姫路,5,1593,2295,2236,2096,1842,1829,2475,14366,756,1257,1452,1483,1466,2063,3172,11649
奈良県,2901,奈良,1,1283,1730,1738,1525,1225,864,910,9275,986,1266,1245,1040,744,644,845,6770
奈良県,2901,奈良,2,1768,2095,2034,1653,1326,886,817,10579,1832,2207,2258,1732,1246,931,976,11182
奈良県,2901,奈良,3,546,705,731,589,450,295,263,3579,605,780,870,626,475,394,393,4143
奈良県,2901,奈良,4,523,658,689,569,469,294,265,3467,458,598,645,497,460,327,308,3293
奈良県,2901,奈良,5,611,940,1152,1041,907,755,769,6175,343,570,685,743,570,613,796,4320
奈良県,2902,東和,1,800,998,1039,905,761,699,956,6158,474,559,628,525,497,548,820,4051
奈良県,2902,東和,2,872,1143,1024,874,821,682,708,6124,891,1055,1080,925,856,739,921,6467
奈良県,2902,東和,3,269,365,367,303,257,232,232,2025,319,432,423,372,310,297,350,2503
奈良県,2902,東和,4,241,316,293,259,222,175,176,1682,258,287,293,277,263,242,275,1895
奈良県,2902,東和,5,304,434,535,485,434,386,532,3110,147,257,281,365,361,439,644,2494
奈良県,2903,西和,1,1452,1919,1787,1455,1172,988,1529,10302,986,1181,1123,838,829,914,1547,7418
奈良県,2903,西和,2,1754,2153,2093,1602,1301,988,1158,11049,1686,2164,2084,1609,1260,1223,1779,11805
奈良県,2903,西和,3,642,750,727,610,447,355,433,3964,661,817,805,669,501,546,792,4791
奈良県,2903,西和,4,510,720,665,546,403,322,402,3568,471,639,584,528,439,474,616,3751
奈良県,2903,西和,5,604,996,1200,993,869,815,1191,6668,347,548,697,692,701,832,1397,5214
奈良県,2904,中和,1,1645,2088,2086,1630,1317,1080,1503,11349,1001,1198,1161,1008,867,890,1426,7551
奈良県,2904,中和,2,1934,2315,2163,1766,1440,1144,1234,11996,1850,2402,2402,1861,1521,1425,1737,13198
奈良県,2904,中和,3,631,798,801,641,483,421,435,4210,695,835,892,761,596,531,678,4988
奈良県,2904,中和,4,532,718,658,608,431,317,344,3608,454,570,636,536,418,426,479,3519
奈良県,2904,中和,5,637,956,1175,1029,890,787,937,6411,358,495,671,713,676,747,1137,4797
奈良県,2905,南和,1,204,265,315,319,324,296,296,2019,132,164,176,223,222,197,224,1338
奈良県,2905,南和,2,194,284,322,249,296,239,215,1799,233,311,296,315,331,239,277,2002
奈良県,2905,南和,3,81,82,93,113,85,69,85,608,81,121,103,116,119,122,88,750
奈良県,2905,南和,4,52,85,78,90,77,67,56,505,54,71,73,100,94,78,78,548
奈良県,2905,南和,5,73,97,120,134,163,134,112,833,43,63,77,109,115,112,156,675
和歌山県,3001,和歌山,1,1853,2452,2284,1976,1702,1425,2147,13839,958,1236,1199,1134,977,1165,2065,8734
和歌山県,3001,和歌山,2,2098,2474,2465,1910,1529,1302,1413,13191,1739,2290,2277,1892,1663,1600,2204,13665
和歌山県,3001,和歌山,3,765,960,897,747,623,536,591,5119,663,832,846,708,613,661,841,5164
和歌山県,3001,和歌山,4,596,730,668,548,473,334,388,3737,363,455,538,447,372,379,577,3131
和歌山県,3001,和歌山,5,640,960,1032,923,884,830,1058,6327,329,476,573,631,588,821,1276,4694
和歌山県,3002,那賀,1,483,618,566,508,485,443,625,3728,251,306,326,320,323,334,510,2370
和歌山県,3002,那賀,2,499,668,632,554,454,379,387,3573,482,645,662,616,511,475,570,3961
和歌山県,3002,那賀,3,213,238,249,216,182,153,171,1422,190,263,264,228,210,220,240,1615
和歌山県,3002,那賀,4,145,214,196,151,146,120,103,1075,107,144,158,164,139,124,150,986
和歌山県,3002,那賀,5,144,225,256,216,247,268,309,1665,86,134,179,190,195,296,375,1455
和歌山県,3003,橋本,1,285,385,353,361,365,370,480,2599,165,187,224,213,248,299,421,1757
和歌山県,3003,橋本,2,351,449,429,376,355,316,374,2650,313,455,441,410,394,402,491,2906
和歌山県,3003,橋本,3,127,189,131,136,133,143,133,992,127,178,166,177,192,145,178,1163
和歌山県,3003,橋本,4,112,127,125,99,110,104,60,737,95,141,129,127,111,98,107,808
和歌山県,3003,橋本,5,101,167,187,207,234,239,277,1412,86,106,162,137,201,249,315,1256
和歌山県,3004,有田,1,303,415,419,351,313,358,419,2578,220,265,270,246,250,241,332,1824
和歌山県,3004,有田,2,303,378,353,293,254,255,308,2144,337,362,392,378,342,398,386,2595
和歌山県,3004,有田,3,126,148,116,121,115,85,106,817,113,134,184,125,128,106,120,910
和歌山県,3004,有田,4,95,113,84,83,76,57,68,576,73,88,100,73,76,84,90,584
和歌山県,3004,有田,5,105,139,132,141,155,127,154,953,59,81,85,100,117,153,178,773
和歌山県,3005,御坊,1,326,449,414,395,372,373,475,2804,206,221,213,226,248,299,340,1753
和歌山県,3005,御坊,2,267,342,272,225,260,235,201,1802,271,338,326,308,298,295,326,2162
和歌山県,3005,御坊,3,148,160,151,120,101,88,80,848,114,163,149,114,107,142,96,885
和歌山県,3005,御坊,4,91,103,87,68,64,67,44,524,60,92,99,86,82,64,72,555
和歌山県,3005,御坊,5,122,135,132,154,141,143,164,991,60,59,98,104,102,158,178,759
和歌山県,3006,田辺,1,584,796,758,681,672,609,729,4829,347,434,488,474,452,460,630,3285
和歌山県,3006,田辺,2,550,708,652,586,553,419,381,3849,625,765,708,701,596,538,581,4514
和歌山県,3006,田辺,3,196,243,204,217,178,158,148,1344,198,275,239,274,247,222,227,1682
和歌山県,3006,田辺,4,162,183,173,150,129,109,105,1011,150,154,161,168,143,115,147,1038
和歌山県,3006,田辺,5,173,244,255,243,250,228,272,1665,119,122,163,182,207,247,317,1357
和歌山県,3007,新宮,1,204,263,267,245,247,249,405,1880,142,145,158,165,168,215,391,1384
和歌山県,3007,新宮,2,204,298,319,263,248,228,266,1826,199,267,288,299,281,324,390,2048
和歌山県,3007,新宮,3,101,113,110,113,96,78,100,711,78,108,125,106,117,126,172,832
和歌山県,3007,新宮,4,66,104,75,88,70,60,62,525,47,57,73,77,72,90,95,511
和歌山県,3007,新宮,5,73,129,155,126,160,131,205,979,37,71,70,91,131,161,237,798
鳥取県,3101,東部,1,1065,1265,1054,1005,1068,951,1123,7531,657,772,647,640,625,659,954,4954
鳥取県,3101,東部,2,1516,1643,1365,1205,1075,951,813,8568,1472,1574,1418,1305,1242,1176,1116,9303
鳥取県,3101,東部,3,504,610,501,446,396,320,265,3042,470,524,503,460,432,428,413,3230
鳥取県,3101,東部,4,445,505,450,354,315,269,225,2563,363,480,484,365,369,366,311,2738
鳥取県,3101,東部,5,533,728,655,662,608,648,790,4624,268,436,445,457,518,657,858,3639
鳥取県,3102,中部,1,480,477,471,403,417,476,538,3262,290,350,251,261,308,311,440,2211
鳥取県,3102,中部,2,494,598,505,501,483,371,323,3275,510,636,528,492,502,489,431,3588
鳥取県,3102,中部,3,206,212,169,183,143,125,95,1133,142,191,178,153,138,142,122,1066
鳥取県,3102,中部,4,147,155,140,144,131,93,75,885,120,160,145,178,152,135,133,1023
鳥取県,3102,中部,5,183,198,232,187,221,222,270,1513,103,139,175,150,213,264,361,1405
鳥取県,3103,西部,1,1003,1213,1141,1003,964,934,1049,7307,644,784,673,612,589,630,973,4905
鳥取県,3103,西部,2,1347,1512,1351,1145,997,775,756,7883,1288,1544,1396,1226,1111,911,1026,8502
鳥取県,3103,西部,3,493,536,465,409,342,258,240,2743,462,493,480,378,361,320,353,2847
鳥取県,3103,西部,4,422,495,417,349,274,242,220,2419,347,416,353,328,287,255,299,2285
鳥取県,3103,西部,5,436,648,631,555,548,517,573,3908,240,344,380,432,431,484,714,3025
島根県,3201,松江,1,1103,1329,1251,1037,1085,955,1166,7926,729,879,754,713,657,650,1122,5504
島根県,3201,松江,2,1616,1816,1623,1279,1111,933,957,9335,1543,1854,1640,1355,1231,1102,1345,10070
島根県,3201,松江,3,566,635,607,500,443,331,304,3386,551,739,678,549,508,452,483,3960
島根県,3201,松江,4,428,526,493,412,327,254,289,2729,344,464,440,382,356,340,357,2683
島根県,3201,松江,5,449,681,724,662,666,674,832,4688,250,394,475,518,554,643,908,3742
島根県,3202,雲南,1,271,294,266,271,333,378,430,2243,176,188,185,183,220,199,321,1472
島根県,3202,雲南,2,315,406,332,297,345,328,347,2370,345,381,332,345,362,304,337,2406
島根県,3202,雲南,3,131,156,116,103,105,87,86,784,94,136,125,98,119,101,114,787
島根県,3202,雲南,4,97,114,81,82,96,75,88,633,84,111,86,96,94,109,115,695
島根県,3202,雲南,5,98,165,130,128,168,159,213,1061,77,89,100,121,117,185,249,938
島根県,3203,出雲,1,865,1052,926,828,793,846,1081,6391,598,735,568,524,560,625,928,4538
島根県,3203,出雲,2,1067,1205,1030,905,805,698,745,6455,1062,1159,957,877,824,899,970,6748
島根県,3203,出雲,3,481,470,401,380,346,267,252,2597,434,517,464,439,395,344,326,2919
島根県,3203,出雲,4,347,387,342,248,234,197,202,1957,292,321,318,282,264,269,233,1979
島根県,3203,出雲,5,297,443,443,385,442,404,558,2972,172,262,276,342,349,440,596,2437
島根県,3204,大田,1,206,293,204,232,301,309,413,1958,147,192,144,146,210,218,308,1365
島根県,3204,大田,2,328,336,302,248,264,252,303,2033,262,325,317,274,324,344,342,2188
島根県,3204,大田,3,128,123,119,104,103,85,75,737,111,130,101,105,128,107,109,791
島根県,3204,大田,4,62,82,68,66,59,67,62,466,53,80,89,86,92,91,121,612
島根県,3204,大田,5,76,105,115,115,129,154,197,891,45,69,69,104,125,175,264,851
島根県,3205,浜田,1,345,411,351,358,428,427,573,2893,210,256,227,189,262,321,526,1991
島根県,3205,浜田,2,462,526,467,443,454,399,515,3266,435,549,454,467,442,468,569,3384
島根県,3205,浜田,3,175,228,145,161,160,141,145,1155,168,177,194,172,176,164,190,1241
島根県,3205,浜田,4,126,142,136,84,84,116,109,797,90,134,106,109,128,106,182,855
島根県,3205,浜田,5,123,210,206,173,201,215,277,1405,69,91,136,128,183,240,329,1176
島根県,3206,益田,1,284,315,280,294,343,370,517,2403,156,176,150,151,216,297,421,1567
島根県,3206,益田,2,326,438,310,304,340,378,392,2488,306,367,339,327,350,372,501,2562
島根県,3206,益田,3,170,161,112,120,105,108,117,893,109,144,114,113,118,129,136,863
島根県,3206,益田,4,82,98,69,82,83,78,90,582,68,98,88,79,91,99,144,667
島根県,3206,益田,5,113,138,135,146,161,177,228,1098,52,87,85,104,139,230,326,1023
島根県,3207,隠岐,1,109,105,69,102,104,134,155,778,53,79,59,60,71,78,106,506
島根県,3207,隠岐,2,143,124,96,78,89,102,112,744,109,131,96,100,102,111,159,808
島根県,3207,隠岐,3,41,43,37,35,26,22,31,235,58,42,48,25,39,42,36,290
島根県,3207,隠岐,4,23,29,29,21,20,17,31,170,29,36,25,29,25,30,38,212
島根県,3207,隠岐,5,31,53,27,36,44,49,65,305,12,22,23,37,25,63,106,288
岡山県,3301,県南東部,1,4681,6071,5249,4446,3868,3438,3967,31720,2963,3590,3261,2608,2358,2262,3201,20243
岡山県,3301,県南東部,2,5063,5926,5138,4048,3290,2660,2604,28729,4966,6015,5363,4303,3815,3245,3737,31444
岡山県,3301,県南東部,3,2059,2358,2076,1599,1375,1062,1079,11608,2040,2438,2307,1960,1709,1516,1770,13740
岡山県,3301,県南東部,4,1959,2387,2039,1581,1174,907,801,10848,1504,1910,1948,1507,1266,1100,1129,10364
岡山県,3301,県南東部,5,2253,3309,3299,2603,2357,2035,2299,18155,1208,1814,2005,1955,1808,1921,2752,13463
岡山県,3302,県南西部,1,3906,5077,4429,3486,3051,2631,3044,25624,1931,2622,2250,1744,1597,1652,2405,14201
岡山県,3302,県南西部,2,3931,4654,4228,3215,2490,2016,1909,22443,3935,4913,4390,3376,2979,2454,2704,24751
岡山県,3302,県南西部,3,1594,1899,1664,1228,1110,922,797,9214,1516,2028,1852,1327,1281,1163,1297,10464
岡山県,3302,県南西部,4,1415,1657,1403,947,786,653,584,7445,961,1276,1270,942,799,809,806,6863
岡山県,3302,県南西部,5,1478,2215,2258,1863,1567,1551,1824,12756,706,1127,1327,1254,1185,1502,2128,9229
岡山県,3303,高梁・新見,1,220,307,236,256,334,300,324,1977,110,152,125,140,203,216,239,1185
岡山県,3303,高梁・新見,2,288,313,298,285,300,274,245,2003,250,302,272,278,321,311,266,2000
岡山県,3303,高梁・新見,3,85,101,99,102,109,96,68,660,94,117,127,127,139,93,100,797
岡山県,3303,高梁・新見,4,58,94,91,66,83,70,63,525,56,87,63,73,82,68,83,512
岡山県,3303,高梁・新見,5,83,105,125,110,124,148,176,871,51,61,60,86,121,163,225,767
岡山県,3304,真庭,1,217,264,219,219,286,241,348,1794,134,160,124,162,175,185,228,1168
岡山県,3304,真庭,2,263,297,233,212,235,238,205,1683,253,255,255,266,283,270,285,1867
岡山県,3304,真庭,3,83,90,84,60,74,66,63,520,77,84,68,73,75,85,100,562
岡山県,3304,真庭,4,67,62,34,45,52,43,60,363,45,62,48,60,68,93,107,483
岡山県,3304,真庭,5,62,82,68,71,90,105,120,598,38,45,69,71,87,129,153,592
岡山県,3305,津山・英田,1,757,903,761,647,753,745,942,5508,385,460,427,397,456,458,656,3239
岡山県,3305,津山・英田,2,921,1160,1003,795,751,678,630,5938,983,1127,1011,869,935,810,838,6573
岡山県,3305,津山・英田,3,393,416,380,243,292,251,242,2217,384,438,384,337,360,342,347,2592
岡山県,3305,津山・英田,4,258,303,272,180,176,158,150,1497,215,270,251,214,238,184,217,1589
岡山県,3305,津山・英田,5,278,376,339,279,332,336,418,2358,154,251,261,261,309,423,571,2230
広島県,3401,広島,1,6625,8513,7854,6152,4939,3128,2422,39633,3698,4716,4284,3267,2520,1539,1436,21460
広島県,3401,広島,2,9351,11034,10186,7698,5620,2966,1884,48739,8222,9961,9211,6723,4666,2381,1632,42796
広島県,3401,広島,3,3557,4266,3939,3052,2295,1205,706,19020,3246,4130,3843,2913,1929,1117,802,17980
広島県,3401,広島,4,2866,3496,3239,2428,1659,861,568,15117,2048,2629,2534,1973,1330,742,547,11803
広島県,3401,広島,5,3454,5210,5704,4896,3759,2366,1619,27008,1736,2608,3083,2648,2101,1378,1197,14751
広島県,3402,広島西,1,573,773,704,625,591,509,499,4274,322,454,425,356,311,299,335,2502
広島県,3402,広島西,2,803,924,853,710,633,431,354,4708,693,834,753,656,609,406,349,4300
広島県,3402,広島西,3,287,340,317,266,239,188,137,1774,268,309,319,287,235,211,176,1805
広島県,3402,広島西,4,240,286,257,217,206,134,120,1460,169,226,258,202,189,139,116,1299
広島県,3402,広島西,5,316,429,409,410,378,329,363,2634,167,224,249,235,259,282,257,1673
広島県,3403,呉,1,883,1365,1230,1098,955,806,970,7307,451,692,638,560,511,512,920,4284
広島県,3403,呉,2,1025,1382,1349,1104,916,649,565,6990,903,1303,1256,1067,806,570,621,6526
広島県,3403,呉,3,419,571,522,432,396,345,374,3059,447,539,543,487,443,464,613,3536
広島県,3403,呉,4,270,437,409,344,217,146,120,1943,212,324,296,270,210,175,172,1659
広島県,3403,呉,5,331,578,586,590,517,418,413,3433,227,336,349,372,329,312,418,2343
広島県,3404,広島中央,1,1190,1498,1343,1085,883,651,740,7390,591,748,635,489,490,406,566,3925
広島県,3404,広島中央,2,1556,1788,1593,1267,996,615,510,8325,1053,1418,1258,1043,851,584,616,6823
広島県,3404,広島中央,3,587,629,602,497,361,231,228,3135,418,556,542,400,370,259,261,2806
広島県,3404,広島中央,4,475,547,536,423,287,167,161,2596,321,403,386,320,259,176,181,2046
広島県,3404,広島中央,5,509,808,839,694,600,417,440,4307,198,348,431,391,382,367,426,2543
広島県,3405,尾三,1,1075,1442,1263,1112,988,927,998,7805,532,734,637,587,638,593,819,4540
広島県,3405,尾三,2,1241,1454,1276,1081,1048,792,772,7664,1044,1398,1330,1187,1108,974,967,8008
広島県,3405,尾三,3,507,611,478,417,417,345,344,3119,443,539,519,417,459,422,463,3262
広島県,3405,尾三,4,349,471,391,279,254,214,186,2144,266,346,351,296,288,261,259,2067
広島県,3405,尾三,5,376,529,593,497,481,463,586,3525,206,301,345,365,394,451,629,2691
広島県,3406,福山・府中,1,2643,3320,2982,2324,2097,1517,1585,16468,1369,1769,1487,1173,1115,885,1103,8901
広島県,3406,福山・府中,2,2826,3335,2863,2231,1713,1302,1120,15390,2552,3046,2806,2201,1718,1348,1344,15015
広島県,3406,福山・府中,3,1118,1271,1005,818,679,489,442,5822,823,1001,944,706,625,559,593,5251
広島県,3406,福山・府中,4,789,952,801,645,466,338,327,4318,551,708,666,526,438,380,350,3619
広島県,3406,福山・府中,5,1292,1686,1567,1342,1236,1154,1235,9512,663,924,1107,1005,988,1130,1389,7206
広島県,3407,備北,1,352,420,368,352,420,443,500,2855,197,279,212,250,291,336,422,1987
広島県,3407,備北,2,464,520,507,417,430,367,420,3125,440,526,499,429,474,444,398,3210
広島県,3407,備北,3,190,216,165,145,154,182,172,1224,186,225,205,195,202,203,248,1464
広島県,3407,備北,4,141,159,117,104,108,92,84,805,122,136,126,124,117,139,111,875
広島県,3407,備北,5,112,196,186,157,167,196,230,1244,86,93,128,135,163,195,253,1053
山口県,3501,岩国,1,442,658,603,524,525,498,626,3876,236,315,344,285,258,352,588,2378
山口県,3501,岩国,2,586,744,685,611,504,444,438,4012,536,764,727,600,513,478,593,4211
山口県,3501,岩国,3,251,289,337,275,230,202,195,1779,236,284,321,271,249,252,286,1899
山口県,3501,岩国,4,181,237,233,196,132,122,115,1216,123,174,203,174,160,148,163,1145
山口県,3501,岩国,5,201,337,345,306,352,292,402,2235,105,168,213,175,222,303,392,1578
山口県,3502,柳井,1,296,406,380,301,312,321,371,2387,171,195,224,174,204,241,305,1514
山口県,3502,柳井,2,353,458,418,325,338,269,286,2447,316,476,460,365,350,293,377,2637
山口県,3502,柳井,3,140,181,168,160,99,106,74,928,128,163,159,130,129,145,128,982
山口県,3502,柳井,4,85,144,101,81,91,78,49,629,82,96,103,101,91,91,85,649
山口県,3502,柳井,5,122,169,158,119,144,153,133,998,47,83,113,86,120,141,199,789
山口県,3503,周南,1,1226,1584,1503,1109,948,891,1127,8388,558,826,736,580,527,638,1130,4995
山口県,3503,周南,2,1417,1797,1630,1229,1032,764,850,8719,1304,1729,1585,1184,1043,952,1238,9035
山口県,3503,周南,3,559,699,615,460,396,322,341,3392,496,678,608,528,461,429,548,3748
山口県,3503,周南,4,389,577,484,366,315,230,233,2594,305,414,423,344,311,278,339,2414
山口県,3503,周南,5,418,731,780,602,519,514,733,4297,207,356,439,389,426,556,888,3261
山口県,3504,山口・防府,1,1577,2029,1732,1476,1346,1085,1152,10397,759,950,845,698,683,633,816,5384
山口県,3504,山口・防府,2,2015,2374,2154,1691,1419,1064,938,11655,1687,2029,1848,1460,1273,1012,1164,10473
山口県,3504,山口・防府,3,812,969,862,729,617,359,345,4693,636,777,769,615,516,429,391,4133
山口県,3504,山口・防府,4,557,658,576,431,400,268,245,3135,362,416,438,389,333,296,310,2544
山口県,3504,山口・防府,5,622,903,877,814,744,591,688,5239,252,421,482,468,512,526,649,3310
山口県,3505,宇部・小野田,1,1276,1595,1341,1137,1033,902,944,8228,667,756,743,584,534,574,836,4694
山口県,3505,宇部・小野田,2,1294,1503,1348,1094,895,703,712,7549,1110,1348,1305,1024,869,768,906,7330
山口県,3505,宇部・小野田,3,503,585,539,428,408,329,364,3156,432,493,522,444,424,499,534,3348
山口県,3505,宇部・小野田,4,442,519,414,373,279,210,228,2465,293,323,362,320,285,246,279,2108
山口県,3505,宇部・小野田,5,442,700,688,670,587,503,548,4138,205,319,406,438,441,478,666,2953
山口県,3506,下関,1,1250,1467,1237,1019,988,742,495,7198,575,766,745,640,552,334,311,3923
山口県,3506,下関,2,1311,1706,1489,1190,978,634,386,7694,1193,1463,1523,1240,989,541,387,7336
山口県,3506,下関,3,331,437,391,339,255,144,83,1980,286,373,350,324,232,142,99,1806
山口県,3506,下関,4,437,582,520,414,314,233,148,2648,299,410,412,398,287,190,124,2120
山口県,3506,下関,5,265,426,400,405,300,243,145,2184,106,140,196,232,190,139,117,1120
山口県,3507,長門,1,162,179,156,107,176,151,173,1104,79,99,115,84,111,139,151,778
山口県,3507,長門,2,194,206,208,153,158,145,149,1213,176,194,204,196,211,166,179,1326
山口県,3507,長門,3,69,91,66,64,58,49,58,455,66,81,65,65,71,64,67,479
山口県,3507,長門,4,40,65,45,36,39,30,29,284,29,37,44,39,48,43,55,295
山口県,3507,長門,5,47,71,49,58,64,60,76,425,21,31,38,42,61,73,111,377
山口県,3508,萩,1,162,234,242,204,260,255,263,1620,99,136,119,142,144,212,275,1127
山口県,3508,萩,2,229,330,274,251,239,252,250,1825,188,274,297,262,289,296,351,1957
山口県,3508,萩,3,111,122,88,91,86,74,84,656,83,90,100,96,94,112,103,678
山口県,3508,萩,4,54,54,58,54,56,39,55,370,40,59,64,54,55,51,72,395
山口県,3508,萩,5,74,91,96,89,103,129,137,719,28,62,73,67,93,117,150,590
徳島県,3601,東部,1,2049,2474,2368,2045,1889,1811,2562,15198,1235,1569,1466,1219,1198,1471,2246,10404
徳島県,3601,東部,2,2839,3273,2879,2470,2121,1783,1894,17259,2735,3327,3060,2642,2351,2440,2626,19181
徳島県,3601,東部,3,1120,1291,1192,1003,883,849,928,7266,1152,1349,1375,1239,1101,1295,1491,9002
徳島県,3601,東部,4,831,941,832,728,586,431,422,4771,634,771,804,675,642,599,618,4743
徳島県,3601,東部,5,892,1249,1261,1260,1154,1057,1321,8194,532,725,802,870,910,1210,1562,6611
徳島県,3603,南部,1,594,768,649,536,562,683,926,4718,330,399,397,300,346,457,755,2984
徳島県,3603,南部,2,802,892,821,704,650,651,843,5363,657,826,844,754,813,877,1140,5911
徳島県,3603,南部,3,265,309,265,280,253,243,330,1945,272,287,326,332,313,397,494,2421
徳島県,3603,南部,4,217,222,200,184,154,145,157,1279,140,187,171,186,196,212,247,1339
徳島県,3603,南部,5,233,321,297,291,265,283,400,2090,121,167,219,205,246,348,489,1795
徳島県,3605,西部,1,253,259,251,268,331,414,612,2388,111,163,148,168,213,293,462,1558
徳島県,3605,西部,2,295,369,341,349,370,396,344,2464,343,403,371,399,448,442,442,2848
徳島県,3605,西部,3,130,149,150,142,163,180,161,1075,124,165,160,191,196,265,265,1366
徳島県,3605,西部,4,93,92,76,89,93,78,85,606,82,82,100,98,105,110,105,682
徳島県,3605,西部,5,112,102,130,124,129,182,223,1002,65,78,96,112,147,187,278,963
香川県,3702,小豆,1,115,121,110,129,119,141,226,961,60,63,73,76,68,113,192,645
香川県,3702,小豆,2,108,116,114,101,109,106,125,779,125,148,143,140,163,173,213,1105
香川県,3702,小豆,3,40,45,48,44,32,44,64,317,64,64,57,55,55,74,109,478
香川県,3702,小豆,4,33,29,22,18,21,18,15,156,36,37,32,31,32,29,27,224
香川県,3702,小豆,5,35,35,34,42,37,40,82,305,18,33,29,32,36,59,105,312
香川県,3706,東部,1,2422,3025,2672,2210,2090,1781,2553,16753,1476,1996,1699,1357,1258,1293,2357,11436
香川県,3706,東部,2,3179,3899,3474,2764,2216,1843,1883,19258,3132,4004,3634,2888,2596,2253,2762,21269
香川県,3706,東部,3,1306,1587,1458,1072,963,747,891,8024,1354,1597,1505,1168,1081,1102,1439,9246
香川県,3706,東部,4,976,1245,1095,854,698,448,430,5746,766,924,946,728,653,594,605,5216
香川県,3706,東部,5,1173,1754,1690,1485,1223,1111,1385,9821,583,902,1034,949,938,1096,1705,7207
香川県,3707,西部,1,1609,2059,1873,1499,1612,1537,2149,12338,944,1287,1099,928,981,1058,1832,8129
香川県,3707,西部,2,2082,2470,2132,1829,1650,1446,1515,13124,2044,2540,2298,2024,1924,1879,2218,14927
香川県,3707,西部,3,826,938,822,692,635,588,678,5179,838,955,908,808,836,851,1096,6292
香川県,3707,西部,4,627,744,624,531,492,365,346,3729,471,609,598,471,506,469,482,3606
香川県,3707,西部,5,733,1010,950,886,864,874,1117,6434,360,560,599,624,686,886,1347,5062
愛媛県,3801,宇摩,1,402,490,402,383,312,225,232,2446,187,229,203,201,126,124,152,1222
愛媛県,3801,宇摩,2,509,593,548,462,369,303,195,2979,458,567,529,448,371,292,272,2937
愛媛県,3801,宇摩,3,158,216,185,195,154,64,62,1034,140,174,173,126,116,131,74,934
愛媛県,3801,宇摩,4,148,191,134,142,107,48,37,807,89,137,123,100,82,79,61,671
愛媛県,3801,宇摩,5,157,230,226,194,145,126,167,1245,69,90,122,116,99,112,132,740
愛媛県,3802,新居浜・西条,1,1009,1262,1059,909,803,532,572,6146,498,603,547,458,376,333,417,3232
愛媛県,3802,新居浜・西条,2,1342,1565,1312,1147,944,606,556,7472,1164,1421,1275,1096,926,651,700,7233
愛媛県,3802,新居浜・西条,3,417,559,487,422,327,220,188,2620,364,449,463,421,295,254,232,2478
愛媛県,3802,新居浜・西条,4,337,436,376,314,241,174,109,1987,267,308,306,282,219,157,163,1702
愛媛県,3802,新居浜・西条,5,384,539,542,513,430,322,354,3084,185,279,279,297,267,307,374,1988
愛媛県,3803,今治,1,711,929,824,665,642,476,628,4875,349,511,475,365,336,281,471,2788
愛媛県,3803,今治,2,926,1080,1034,819,715,559,612,5745,851,1021,1058,862,749,585,667,5793
愛媛県,3803,今治,3,373,453,379,341,282,217,173,2218,261,394,337,316,289,216,232,2045
愛媛県,3803,今治,4,213,299,246,202,170,124,104,1358,204,221,252,213,192,172,190,1444
愛媛県,3803,今治,5,268,390,400,330,316,310,420,2434,160,230,269,273,266,312,526,2036
愛媛県,3804,松山,1,3270,4163,3644,3004,2613,1853,1594,20141,1839,2204,2044,1647,1467,1167,1226,11594
愛媛県,3804,松山,2,4515,5140,4564,3668,2990,1988,1320,24185,4302,4924,4562,3621,2891,2023,1553,23876
愛媛県,3804,松山,3,1455,1674,1477,1226,1011,596,431,7870,1295,1626,1452,1132,951,659,568,7683
愛媛県,3804,松山,4,1173,1377,1144,913,784,455,321,6167,944,1083,1096,953,810,577,416,5879
愛媛県,3804,松山,5,1526,2211,2263,2002,1880,1324,1059,12265,859,1276,1367,1388,1256,1022,1128,8296
愛媛県,3805,八幡浜・大洲,1,615,775,666,716,771,641,663,4847,345,439,440,438,452,424,479,3017
愛媛県,3805,八幡浜・大洲,2,777,928,781,793,760,619,595,5253,767,830,897,848,741,676,714,5473
愛媛県,3805,八幡浜・大洲,3,218,256,249,223,208,120,94,1368,222,269,257,208,249,173,143,1521
愛媛県,3805,八幡浜・大洲,4,155,209,199,201,162,106,76,1108,154,189,228,218,194,157,136,1276
愛媛県,3805,八幡浜・大洲,5,186,291,302,330,298,224,265,1896,129,201,255,241,236,301,358,1721
愛媛県,3806,宇和島,1,481,585,538,534,521,475,595,3729,283,390,384,345,387,354,476,2619
愛媛県,3806,宇和島,2,575,714,637,594,608,442,472,4042,603,761,744,704,673,646,645,4776
愛媛県,3806,宇和島,3,196,218,191,208,142,99,110,1164,187,232,252,228,186,164,153,1402
愛媛県,3806,宇和島,4,134,183,145,146,105,83,81,877,102,175,149,156,152,137,152,1023
愛媛県,3806,宇和島,5,138,225,207,198,201,200,247,1416,83,147,169,189,216,238,353,1395
高知県,3901,安芸,1,181,218,217,209,242,270,370,1707,94,133,109,136,118,206,325,1121
高知県,3901,安芸,2,227,259,293,254,249,237,272,1791,205,270,255,274,317,377,472,2170
高知県,3901,安芸,3,71,77,65,62,48,35,55,413,55,73,78,65,75,74,69,489
高知県,3901,安芸,4,60,55,49,45,51,29,28,317,41,59,86,49,50,53,61,399
高知県,3901,安芸,5,69,109,87,114,79,79,98,635,40,51,66,84,90,110,179,620
高知県,3902,中央,1,2336,2926,2612,2285,2101,1920,2341,16521,1365,1698,1520,1226,1213,1226,1900,10148
高知県,3902,中央,2,3334,3945,3368,2771,2468,2169,2453,20508,3431,4026,3696,3239,2869,2693,3399,23353
高知県,3902,中央,3,1030,1211,1066,849,738,542,426,5862,1080,1316,1259,961,838,647,648,6749
高知県,3902,中央,4,915,1135,870,769,570,414,414,5087,786,1021,1016,866,745,557,589,5580
高知県,3902,中央,5,1187,1766,1608,1445,1302,1151,1378,9837,678,1043,1126,1157,1195,1303,1667,8169
高知県,3903,高幡,1,205,248,225,244,284,360,490,2056,93,134,130,107,154,196,296,1110
高知県,3903,高幡,2,302,345,349,303,358,350,391,2398,241,339,319,343,375,434,504,2555
高知県,3903,高幡,3,87,93,91,60,84,68,70,553,80,93,80,88,107,92,93,633
高知県,3903,高幡,4,71,60,60,58,55,34,38,376,61,75,79,84,69,68,72,508
高知県,3903,高幡,5,109,125,132,107,97,119,157,846,57,81,73,87,100,176,224,798
高知県,3904,幡多,1,287,368,333,288,344,431,621,2672,157,200,200,156,210,300,485,1708
高知県,3904,幡多,2,410,497,414,376,434,402,463,2996,433,529,472,463,516,619,753,3785
高知県,3904,幡多,3,111,144,117,92,85,85,92,726,127,173,138,146,137,124,138,983
高知県,3904,幡多,4,104,96,90,67,87,57,61,562,91,127,118,105,112,125,126,804
高知県,3904,幡多,5,134,194,167,171,161,226,251,1304,89,154,164,167,184,294,404,1456
福岡県,4001,福岡・糸島,1,7521,8486,7581,6134,5251,4254,4725,43952,4636,5139,4521,3677,3318,3045,4154,28490
福岡県,4001,福岡・糸島,2,11590,12181,10814,7967,6170,4281,3951,56954,11546,12143,10755,7968,6078,4818,4989,58297
福岡県,4001,福岡・糸島,3,4939,5220,4671,3529,2640,1831,1621,24451,5081,5497,4826,3687,2859,2176,2137,26263
福岡県,4001,福岡・糸島,4,3893,4138,3669,2723,2019,1348,1185,18975,2980,3368,3093,2544,1893,1471,1496,16845
福岡県,4001,福岡・糸島,5,3829,5046,5135,4635,3860,3140,3415,29060,2269,2985,3281,3041,2637,2621,3508,20342
福岡県,4002,粕屋,1,1715,2025,1567,1241,1134,941,961,9584,889,1002,805,610,601,551,671,5129
福岡県,4002,粕屋,2,2043,2304,1790,1201,1014,806,653,9811,2023,2136,1611,1287,1035,797,740,9629
福岡県,4002,粕屋,3,885,983,753,508,469,303,249,4150,813,864,723,511,419,374,323,4027
福岡県,4002,粕屋,4,684,723,549,378,343,229,212,3118,500,556,498,391,325,300,259,2829
福岡県,4002,粕屋,5,627,890,778,637,621,572,639,4764,317,469,434,387,441,459,623,3130
福岡県,4003,宗像,1,812,824,664,556,605,533,573,4567,429,427,366,336,334,372,423,2687
福岡県,4003,宗像,2,1018,969,797,624,619,487,433,4947,1036,1015,869,753,661,567,519,5420
福岡県,4003,宗像,3,412,385,334,277,241,197,181,2027,424,416,356,319,273,234,219,2241
福岡県,4003,宗像,4,353,340,260,208,204,168,146,1679,237,280,278,230,206,194,196,1621
福岡県,4003,宗像,5,325,420,385,363,407,423,493,2816,153,233,256,248,313,377,482,2062
福岡県,4004,筑紫,1,1828,2173,1941,1533,1420,1242,1460,11597,1043,1255,1100,891,794,826,1158,7067
福岡県,4004,筑紫,2,2610,2930,2513,1915,1579,1244,1170,13961,2563,2953,2571,2064,1641,1361,1465,14618
福岡県,4004,筑紫,3,1138,1250,1122,910,696,506,526,6148,1148,1256,1194,908,725,608,698,6537
福岡県,4004,筑紫,4,867,995,852,672,526,442,449,4803,686,839,839,665,586,494,562,4671
福岡県,4004,筑紫,5,805,1159,1172,1066,1022,926,1134,7284,445,630,787,776,748,903,1307,5596
福岡県,4005,朝倉,1,383,456,374,347,359,428,491,2838,205,244,187,207,223,293,388,1747
福岡県,4005,朝倉,2,567,564,502,422,412,363,375,3205,460,555,491,469,428,454,472,3329
福岡県,4005,朝倉,3,202,193,188,151,136,145,114,1129,209,204,186,182,192,179,161,1313
福岡県,4005,朝倉,4,134,139,109,104,93,100,98,777,89,133,145,123,125,134,140,889
福岡県,4005,朝倉,5,150,171,157,129,175,177,245,1204,71,86,133,133,150,210,300,1083
福岡県,4006,久留米,1,1830,2113,1787,1713,1593,1487,1763,12286,1037,1242,1139,1060,988,1099,1512,8077
福岡県,4006,久留米,2,2582,2899,2538,2131,1909,1519,1405,14983,2640,2956,2899,2382,2054,1810,2027,16768
福岡県,4006,久留米,3,1049,1057,950,768,725,593,532,5674,889,1069,1022,863,755,686,729,6013
福岡県,4006,久留米,4,661,725,648,571,447,376,416,3844,529,643,656,571,500,522,485,3906
福岡県,4006,久留米,5,699,943,935,855,917,869,1045,6263,355,533,643,672,705,897,1219,5024
福岡県,4007,八女・筑後,1,498,581,587,580,601,553,731,4131,287,362,340,355,395,401,534,2674
福岡県,4007,八女・筑後,2,815,874,773,677,654,571,507,4871,730,867,847,822,728,654,672,5320
福岡県,4007,八女・筑後,3,370,332,277,273,248,237,220,1957,296,318,350,299,273,311,367,2214
福岡県,4007,八女・筑後,4,204,217,152,143,144,124,119,1103,166,186,173,162,162,198,176,1223
福岡県,4007,八女・筑後,5,189,232,238,210,282,264,366,1781,118,134,188,203,229,326,449,1647
福岡県,4008,有明,1,694,815,807,794,802,805,1101,5818,411,520,467,557,498,636,983,4072
福岡県,4008,有明,2,1019,1117,1012,996,968,751,757,6620,959,1108,1157,1075,958,988,1197,7442
福岡県,4008,有明,3,391,416,398,358,334,292,289,2478,364,402,405,411,401,379,445,2807
福岡県,4008,有明,4,248,265,258,234,214,202,213,1634,183,246,219,226,259,323,327,1783
福岡県,4008,有明,5,250,301,326,338,394,436,586,2631,113,188,212,250,309,470,711,2253
福岡県,4009,飯塚,1,758,821,665,579,677,689,875,5064,459,541,483,354,506,559,803,3705
福岡県,4009,飯塚,2,1010,1103,910,715,796,696,818,6048,1022,1199,1029,853,867,881,1022,6873
福岡県,4009,飯塚,3,352,375,293,296,238,229,259,2042,403,391,365,323,327,365,449,2623
福岡県,4009,飯塚,4,265,275,209,193,209,187,242,1580,202,257,237,230,269,243,343,1781
福岡県,4009,飯塚,5,251,362,318,275,348,378,547,2479,141,226,200,223,301,436,684,2211
福岡県,4010,直方・鞍手,1,567,565,439,383,451,408,546,3359,259,289,281,238,249,317,425,2058
福岡県,4010,直方・鞍手,2,630,639,542,443,464,430,474,3622,519,568,546,483,477,498,563,3654
福岡県,4010,直方・鞍手,3,212,237,176,144,150,141,166,1226,209,201,219,164,215,178,243,1429
福岡県,4010,直方・鞍手,4,185,182,146,124,125,125,112,999,134,127,152,129,118,149,198,1007
福岡県,4010,直方・鞍手,5,151,197,195,184,213,213,304,1457,80,101,112,136,159,244,373,1205
福岡県,4011,田川,1,450,513,468,375,450,492,561,3309,290,337,290,293,285,362,473,2330
福岡県,4011,田川,2,567,694,561,482,486,481,482,3753,599,711,678,574,572,597,597,4328
福岡県,4011,田川,3,223,226,194,171,173,157,157,1301,219,235,204,229,189,222,249,1547
福岡県,4011,田川,4,161,165,138,129,100,92,108,893,117,146,125,127,127,140,162,944
福岡県,4011,田川,5,133,185,175,138,174,185,262,1252,65,115,112,115,179,209,325,1120
福岡県,4012,北九州,1,4874,5744,5266,4396,4402,3876,4926,33484,2687,3203,3178,2641,2477,2716,4549,21451
福岡県,4012,北九州,2,6380,7165,6419,5067,4484,3774,3957,37246,5723,6813,6665,5319,4482,3972,5270,38244
福岡県,4012,北九州,3,2363,2601,2275,1919,1668,1362,1509,13697,2252,2649,2495,2144,1817,1793,2172,15322
福岡県,4012,北九州,4,1849,2214,1888,1514,1264,1062,1053,10844,1361,1727,1710,1470,1201,1300,1564,10333
福岡県,4012,北九州,5,1897,2621,2798,2614,2406,2294,2758,17388,970,1387,1682,1777,1761,2171,3321,13069
福岡県,4013,京築,1,936,1144,1000,947,922,792,1007,6748,398,599,544,455,472,577,876,3921
福岡県,4013,京築,2,1089,1285,1162,910,823,741,751,6761,1000,1157,1094,914,888,889,1019,6961
福岡県,4013,京築,3,388,468,385,306,249,284,255,2335,399,436,411,314,334,385,391,2670
福岡県,4013,京築,4,315,378,333,250,217,218,234,1945,220,318,302,245,206,281,319,1891
福岡県,4013,京築,5,318,425,434,384,420,454,598,3033,161,229,238,292,342,432,631,2325
佐賀県,4101,中部,1,1578,1668,1581,1549,1424,1418,1657,10875,910,993,975,868,918,959,1275,6898
佐賀県,4101,中部,2,2020,2182,1903,1684,1504,1323,1156,11772,1942,2296,2020,1803,1638,1442,1383,12524
佐賀県,4101,中部,3,798,830,769,682,625,495,419,4618,769,938,868,802,716,600,584,5277
佐賀県,4101,中部,4,677,766,694,554,462,431,353,3937,566,628,636,638,505,543,486,4002
佐賀県,4101,中部,5,609,896,911,940,952,969,1217,6494,345,494,620,657,748,1073,1330,5267
佐賀県,4102,東部,1,626,737,625,543,480,458,571,4040,326,330,353,251,253,343,505,2361
佐賀県,4102,東部,2,865,929,730,578,512,462,446,4522,677,850,699,535,510,487,607,4365
佐賀県,4102,東部,3,383,308,283,247,211,147,179,1758,298,327,300,201,221,189,260,1796
佐賀県,4102,東部,4,295,296,260,197,155,131,141,1475,190,239,228,162,176,203,222,1420
佐賀県,4102,東部,5,273,357,320,293,288,359,508,2398,116,165,219,214,272,387,551,1924
佐賀県,4103,北部,1,474,528,447,518,582,599,698,3846,354,383,304,362,429,497,598,2927
佐賀県,4103,北部,2,609,694,542,488,488,447,464,3732,647,732,627,591,603,565,568,4333
佐賀県,4103,北部,3,223,253,200,179,196,180,180,1411,208,263,236,234,224,232,203,1600
佐賀県,4103,北部,4,197,192,163,140,133,112,133,1070,165,172,161,188,179,159,156,1180
佐賀県,4103,北部,5,198,267,267,243,229,234,258,1696,95,142,166,205,229,239,286,1362
佐賀県,4104,西部,1,404,373,347,350,352,402,395,2623,191,197,179,208,250,283,412,1720
佐賀県,4104,西部,2,472,499,422,397,391,359,316,2856,462,465,448,463,407,421,394,3060
佐賀県,4104,西部,3,147,131,117,150,117,104,112,878,132,165,157,125,154,128,157,1018
佐賀県,4104,西部,4,145,158,145,99,108,78,93,826,108,127,115,126,109,133,129,847
佐賀県,4104,西部,5,138,150,181,163,191,202,282,1307,83,86,105,119,149,244,392,1178
佐賀県,4105,南部,1,634,617,608,638,772,757,993,5019,348,391,322,362,474,550,903,3350
佐賀県,4105,南部,2,700,748,700,723,620,643,682,4816,642,743,743,731,792,791,843,5285
佐賀県,4105,南部,3,253,251,251,266,261,231,224,1737,231,259,293,267,292,327,296,1965
佐賀県,4105,南部,4,204,232,189,226,172,153,150,1326,147,176,198,213,239,252,243,1468
佐賀県,4105,南部,5,193,267,265,329,306,360,503,2223,101,146,176,216,273,502,699,2113
長崎県,4201,長崎,1,2085,2670,2683,2468,2384,2236,2879,17405,1391,1728,1591,1569,1633,1871,2831,12614
長崎県,4201,長崎,2,2371,2705,2642,2345,2034,1691,1677,15465,2561,2927,2809,2435,2159,2040,2256,17187
長崎県,4201,長崎,3,1058,1202,1112,960,948,833,879,6992,1075,1254,1278,1083,951,997,1191,7829
長崎県,4201,長崎,4,817,988,878,706,633,526,575,5123,710,920,968,829,703,708,788,5626
長崎県,4201,長崎,5,843,1302,1418,1361,1219,1306,1697,9146,508,721,831,943,1035,1346,1893,7277
長崎県,4202,佐世保県北,1,988,1154,1119,1098,1155,1238,1608,8360,622,767,745,693,740,997,1494,6058
長崎県,4202,佐世保県北,2,1268,1455,1238,1201,1135,1068,1101,8466,1264,1453,1386,1283,1238,1212,1393,9229
長崎県,4202,佐世保県北,3,482,545,516,439,420,388,430,3220,556,566,526,533,470,557,567,3775
長崎県,4202,佐世保県北,4,330,419,339,334,280,263,243,2208,314,355,396,338,310,358,392,2463
長崎県,4202,佐世保県北,5,388,507,521,567,565,626,772,3946,217,324,389,322,467,758,987,3464
長崎県,4203,県央,1,1256,1495,1340,1300,1292,1266,1442,9391,730,762,789,858,781,985,1424,6329
長崎県,4203,県央,2,1358,1552,1406,1163,1049,913,896,8337,1381,1560,1436,1236,1168,1092,1177,9050
長崎県,4203,県央,3,603,629,564,505,464,415,394,3574,592,676,654,552,513,575,665,4227
長崎県,4203,県央,4,475,495,479,423,339,230,217,2658,402,416,478,377,365,355,314,2707
長崎県,4203,県央,5,530,703,709,707,650,692,780,4771,259,378,469,480,524,678,991,3779
長崎県,4204,県南,1,544,599,724,749,892,992,1338,5838,366,454,522,551,710,939,1297,4839
長崎県,4204,県南,2,491,532,476,483,525,386,318,3211,492,587,607,615,564,493,429,3787
長崎県,4204,県南,3,179,217,199,179,177,148,151,1250,204,243,225,218,260,286,256,1692
長崎県,4204,県南,4,142,162,132,141,129,114,100,920,137,153,205,186,201,220,218,1320
長崎県,4204,県南,5,148,226,220,265,248,322,422,1851,120,151,189,236,301,448,651,2096
長崎県,4206,五島,1,116,134,166,166,182,239,276,1279,71,68,86,103,137,196,271,932
長崎県,4206,五島,2,137,142,144,142,157,142,133,997,139,135,168,158,192,178,155,1125
長崎県,4206,五島,3,64,68,58,53,65,62,51,421,52,74,66,63,75,78,76,484
長崎県,4206,五島,4,47,63,39,49,33,37,39,307,36,53,48,53,54,71,54,369
長崎県,4206,五島,5,35,55,58,52,65,95,111,471,30,28,39,49,83,118,161,508
長崎県,4207,上五島,1,83,128,127,142,158,168,168,974,40,70,83,108,116,119,169,705
長崎県,4207,上五島,2,109,98,116,118,112,94,74,721,65,94,86,110,117,112,77,661
長崎県,4207,上五島,3,35,44,28,33,34,29,29,232,29,32,32,27,34,36,40,230
長崎県,4207,上五島,4,40,37,27,32,28,28,29,221,28,35,22,27,33,31,43,219
長崎県,4207,上五島,5,33,41,34,51,48,68,56,331,24,18,21,44,42,70,92,311
長崎県,4208,壱岐,1,93,103,102,111,130,155,226,920,71,67,61,79,79,108,189,654
長崎県,4208,壱岐,2,152,160,160,153,159,152,155,1091,164,180,144,180,157,178,210,1213
長崎県,4208,壱岐,3,53,50,52,46,39,41,40,321,55,59,54,68,69,56,69,430
長崎県,4208,壱岐,4,33,53,44,28,26,20,29,233,24,44,29,29,38,43,44,251
長崎県,4208,壱岐,5,24,39,51,37,44,55,76,326,21,21,28,21,37,76,96,300
長崎県,4209,対馬,1,139,140,151,141,202,235,324,1332,61,86,98,106,145,223,285,1004
長崎県,4209,対馬,2,129,161,122,131,124,127,103,897,169,170,142,156,158,151,131,1077
長崎県,4209,対馬,3,42,66,54,48,61,60,46,377,42,47,57,60,78,75,81,440
長崎県,4209,対馬,4,47,45,36,29,30,37,37,261,37,46,38,33,50,46,51,301
長崎県,4209,対馬,5,32,43,57,47,61,72,81,393,25,24,37,39,48,101,127,401
熊本県,4302,宇城,1,415,451,416,463,457,397,394,2993,240,251,228,206,223,259,276,1683
熊本県,4302,宇城,2,552,592,559,533,481,353,256,3326,497,583,558,503,470,353,286,3250
熊本県,4302,宇城,3,255,246,195,213,173,134,117,1333,224,252,252,218,213,168,138,1465
熊本県,4302,宇城,4,161,169,145,142,113,89,86,905,141,142,145,135,150,124,94,931
熊本県,4302,宇城,5,169,230,252,302,260,221,241,1675,93,138,177,203,169,174,216,1170
熊本県,4303,有明,1,713,702,623,645,713,704,814,4914,366,420,368,368,425,451,555,2953
熊本県,4303,有明,2,834,803,720,636,616,559,508,4676,693,830,741,699,692,572,627,4854
熊本県,4303,有明,3,344,324,297,299,230,224,206,1924,360,371,389,349,336,301,284,2390
熊本県,4303,有明,4,204,219,160,159,158,119,114,1133,173,186,163,165,163,190,204,1244
熊本県,4303,有明,5,237,282,288,312,281,342,405,2147,109,196,204,229,264,358,477,1837
熊本県,4304,鹿本,1,197,186,194,207,217,228,278,1507,107,123,111,123,131,154,209,958
熊本県,4304,鹿本,2,263,269,257,253,267,216,182,1707,255,287,316,270,266,231,246,1871
熊本県,4304,鹿本,3,144,108,108,100,92,83,82,717,118,104,108,102,98,104,81,715
熊本県,4304,鹿本,4,79,85,69,65,56,45,47,446,64,76,70,68,78,61,47,464
熊本県,4304,鹿本,5,90,130,129,99,105,115,145,813,36,58,82,91,102,125,153,647
熊本県,4305,菊池,1,932,997,756,758,726,597,658,5424,522,483,395,381,327,368,391,2867
熊本県,4305,菊池,2,1438,1413,1086,887,791,659,530,6804,1410,1372,1050,991,863,698,611,6995
熊本県,4305,菊池,3,649,615,456,420,338,287,198,2963,574,603,491,404,396,327,305,3100
熊本県,4305,菊池,4,464,500,348,324,256,191,147,2230,363,366,367,288,259,208,220,2071
熊本県,4305,菊池,5,464,640,612,557,499,524,550,3846,263,339,338,357,386,435,511,2629
熊本県,4306,阿蘇,1,186,206,195,236,234,275,252,1584,145,133,115,143,152,185,214,1087
熊本県,4306,阿蘇,2,321,298,282,299,296,270,230,1996,282,338,323,350,306,298,184,2081
熊本県,4306,阿蘇,3,113,120,105,110,105,100,69,722,124,136,151,126,143,124,85,889
熊本県,4306,阿蘇,4,88,95,74,81,64,68,43,513,90,86,97,99,82,73,74,601
熊本県,4306,阿蘇,5,94,123,121,121,137,106,145,847,43,65,89,98,109,113,145,662
熊本県,4308,八代,1,524,583,603,547,541,509,544,3851,301,348,325,310,341,363,429,2417
熊本県,4308,八代,2,776,796,704,675,613,430,313,4307,724,847,753,714,663,493,419,4613
熊本県,4308,八代,3,307,341,295,257,227,167,128,1722,295,346,342,322,311,238,201,2055
熊本県,4308,八代,4,267,258,211,197,166,131,96,1326,216,233,230,240,207,169,166,1461
熊本県,4308,八代,5,205,317,307,363,303,289,288,2072,111,193,215,268,250,319,350,1706
熊本県,4309,芦北,1,160,190,178,205,220,160,151,1264,83,77,79,106,89,94,87,615
熊本県,4309,芦北,2,178,167,220,216,175,124,86,1166,186,198,217,198,201,154,106,1260
熊本県,4309,芦北,3,72,86,93,87,68,67,38,511,71,81,103,104,110,80,58,607
熊本県,4309,芦北,4,72,78,69,59,58,53,25,414,46,62,62,65,56,38,39,368
熊本県,4309,芦北,5,68,96,127,135,107,91,82,706,30,49,60,81,77,78,87,462
熊本県,4310,球磨,1,317,383,323,398,478,499,554,2952,183,239,226,246,315,342,454,2005
熊本県,4310,球磨,2,551,571,574,608,646,579,535,4064,606,648,648,673,681,601,582,4439
熊本県,4310,球磨,3,190,195,192,207,177,162,180,1303,228,225,191,206,208,234,247,1539
熊本県,4310,球磨,4,127,160,112,106,123,122,137,887,108,157,154,141,145,179,183,1067
熊本県,4310,球磨,5,120,158,189,195,228,251,330,1471,62,87,126,153,162,262,443,1295
熊本県,4311,天草,1,474,569,598,601,738,708,793,4481,321,421,415,517,515,578,634,3401
熊本県,4311,天草,2,550,539,532,567,590,479,392,3649,588,640,704,693,656,589,465,4335
熊本県,4311,天草,3,176,182,180,188,182,166,96,1170,211,261,232,243,233,225,159,1564
熊本県,4311,天草,4,143,176,140,108,114,106,72,859,145,161,156,199,163,159,122,1105
熊本県,4311,天草,5,140,193,218,219,228,202,239,1439,86,141,171,192,256,299,339,1484
熊本県,4312,熊本・上益城,1,3188,3563,3134,2916,2837,2598,2881,21117,1904,2114,1862,1759,1578,1640,2428,13285
熊本県,4312,熊本・上益城,2,5080,5513,4679,4112,3484,2796,2330,27994,5250,5821,5052,4428,3588,3152,3146,30437
熊本県,4312,熊本・上益城,3,2169,2395,2089,1811,1526,1140,940,12070,2286,2584,2435,1991,1733,1488,1457,13974
熊本県,4312,熊本・上益城,4,1569,1813,1433,1282,1070,800,714,8681,1315,1621,1528,1311,1184,941,965,8865
熊本県,4312,熊本・上益城,5,1786,2443,2481,2567,2365,2003,1974,15619,1090,1574,1670,1842,1746,1783,2111,11816
大分県,4401,東部,1,672,833,761,745,844,962,1292,6109,463,559,586,556,583,755,1258,4760
大分県,4401,東部,2,935,1097,982,874,899,758,767,6312,988,1184,1152,1093,993,896,1037,7343
大分県,4401,東部,3,350,369,403,325,358,343,397,2545,426,477,508,423,488,461,592,3375
大分県,4401,東部,4,296,366,282,274,246,184,201,1849,292,329,356,330,318,294,339,2258
大分県,4401,東部,5,305,392,421,395,428,514,674,3129,200,296,342,415,464,626,865,3208
大分県,4403,中部,1,2536,3124,2503,2245,2346,2166,2623,17543,1622,1756,1548,1346,1367,1453,2257,11349
大分県,4403,中部,2,3703,4081,3453,2738,2639,2099,1755,20468,3572,4176,3663,2979,2809,2363,2479,22041
大分県,4403,中部,3,1647,1879,1549,1269,1185,1055,965,9549,1693,1994,1873,1565,1478,1297,1363,11263
大分県,4403,中部,4,1122,1230,1057,814,777,554,553,6107,895,1044,1028,918,780,707,738,6110
大分県,4403,中部,5,1187,1680,1639,1594,1579,1586,1746,11011,613,960,1119,1071,1137,1458,1963,8321
大分県,4405,南部,1,300,332,325,330,332,396,469,2484,163,193,198,181,223,279,414,1651
大分県,4405,南部,2,297,338,278,315,243,182,84,1737,295,304,341,294,253,119,74,1680
大分県,4405,南部,3,153,178,140,139,188,296,441,1535,185,181,211,220,347,485,652,2281
大分県,4405,南部,4,110,110,105,102,105,194,290,1016,90,114,121,134,179,356,472,1466
大分県,4405,南部,5,79,116,124,104,119,71,40,653,35,65,63,71,63,42,36,375
大分県,4406,豊肥,1,190,203,224,239,358,353,506,2073,142,161,139,143,248,294,421,1548
大分県,4406,豊肥,2,255,282,247,248,312,294,353,1991,273,261,307,297,349,359,315,2161
大分県,4406,豊肥,3,90,109,95,93,129,99,83,698,127,136,119,124,156,144,134,940
大分県,4406,豊肥,4,75,72,63,60,81,65,70,486,57,79,70,87,116,88,110,607
大分県,4406,豊肥,5,81,97,117,90,126,197,267,975,49,73,78,88,167,260,409,1124
大分県,4408,西部,1,334,402,396,389,450,500,535,3006,195,255,228,223,280,348,475,2004
大分県,4408,西部,2,531,607,513,545,564,450,373,3583,497,541,508,543,544,453,459,3545
大分県,4408,西部,3,183,191,168,188,177,131,117,1155,170,185,190,175,188,155,165,1228
大分県,4408,西部,4,121,165,131,127,136,91,86,857,102,145,145,154,131,110,126,913
大分県,4408,西部,5,134,170,185,195,228,262,363,1537,93,104,159,170,219,297,416,1458
大分県,4409,北部,1,941,1094,947,918,852,806,1006,6564,435,504,495,455,518,607,831,3845
大分県,4409,北部,2,1024,1085,954,849,758,642,562,5874,832,918,899,809,823,770,780,5831
大分県,4409,北部,3,375,365,309,254,267,201,162,1933,258,290,329,293,279,281,263,1993
大分県,4409,北部,4,286,242,257,210,190,162,125,1472,182,264,216,197,192,183,214,1448
大分県,4409,北部,5,276,352,336,328,329,337,486,2444,140,184,238,235,320,455,696,2268
宮崎県,4501,宮崎東諸県,1,1636,2001,1760,1640,1551,1381,1376,11345,970,1163,977,898,806,845,1143,6802
宮崎県,4501,宮崎東諸県,2,2965,3350,2847,2281,1967,1417,1165,15992,2733,3144,2805,2248,1838,1570,1610,15948
宮崎県,4501,宮崎東諸県,3,1222,1367,1168,993,841,631,556,6778,1167,1411,1236,1034,911,731,732,7222
宮崎県,4501,宮崎東諸県,4,886,1008,845,740,611,459,417,4966,694,873,849,717,619,546,570,4868
宮崎県,4501,宮崎東諸県,5,968,1298,1339,1236,1168,1105,1397,8511,454,730,771,789,772,983,1468,5967
宮崎県,4502,都城北諸県,1,742,796,623,664,812,861,1280,5778,381,395,393,390,530,759,1282,4130
宮崎県,4502,都城北諸県,2,1158,1187,978,897,918,641,523,6302,1039,1137,981,889,886,716,621,6269
宮崎県,4502,都城北諸県,3,501,480,389,338,412,473,629,3222,414,483,469,463,588,826,1051,4294
宮崎県,4502,都城北諸県,4,354,370,294,229,268,211,196,1922,256,281,286,272,281,284,253,1913
宮崎県,4502,都城北諸県,5,293,376,410,401,451,506,695,3132,171,228,258,303,363,582,863,2768
宮崎県,4503,延岡西臼杵,1,658,787,736,728,729,602,887,5127,286,350,384,339,374,409,660,2802
宮崎県,4503,延岡西臼杵,2,1013,1165,997,892,792,693,697,6249,809,969,872,790,805,772,847,5864
宮崎県,4503,延岡西臼杵,3,405,479,404,380,333,287,333,2621,341,438,400,352,351,411,451,2744
宮崎県,4503,延岡西臼杵,4,314,306,354,264,222,198,207,1865,215,252,234,269,266,314,316,1866
宮崎県,4503,延岡西臼杵,5,277,388,433,388,359,414,567,2826,148,192,228,253,262,425,725,2233
宮崎県,4504,日南串間,1,204,235,226,254,330,327,399,1975,101,136,115,137,165,226,369,1249
宮崎県,4504,日南串間,2,289,268,273,268,287,254,233,1872,246,246,263,269,286,285,358,1953
宮崎県,4504,日南串間,3,129,155,141,129,120,138,135,947,115,128,113,157,155,174,214,1056
宮崎県,4504,日南串間,4,88,101,88,86,82,66,70,581,78,67,84,106,101,117,105,658
宮崎県,4504,日南串間,5,93,103,110,96,131,164,223,920,42,67,73,91,114,190,259,836
宮崎県,4505,西諸,1,229,215,204,249,300,356,464,2017,122,115,101,130,198,268,358,1292
宮崎県,4505,西諸,2,325,307,277,319,347,385,446,2406,295,309,284,381,384,469,531,2653
宮崎県,4505,西諸,3,147,145,115,117,138,116,128,906,165,151,139,142,158,177,185,1117
宮崎県,4505,西諸,4,108,121,84,100,112,89,123,737,78,88,108,112,129,144,174,833
宮崎県,4505,西諸,5,90,95,122,118,167,203,301,1096,49,69,67,107,135,208,353,988
宮崎県,4506,西都児湯,1,280,389,299,327,386,484,572,2737,187,227,203,184,239,314,455,1809
宮崎県,4506,西都児湯,2,515,499,449,422,418,436,431,3170,485,557,510,483,475,501,560,3571
宮崎県,4506,西都児湯,3,190,212,195,181,189,163,161,1291,169,220,209,212,241,256,255,1562
宮崎県,4506,西都児湯,4,151,125,128,116,107,118,94,839,125,141,138,128,138,153,143,966
宮崎県,4506,西都児湯,5,129,198,160,183,208,297,407,1582,93,132,128,151,189,342,542,1577
宮崎県,4507,日向入郷,1,276,312,262,242,283,328,431,2134,152,183,145,128,166,221,366,1361
宮崎県,4507,日向入郷,2,409,456,376,355,315,298,256,2465,375,378,393,320,289,274,331,2360
宮崎県,4507,日向入郷,3,182,199,153,165,155,147,147,1148,216,210,205,168,195,189,233,1416
宮崎県,4507,日向入郷,4,139,156,106,96,86,106,122,811,112,135,131,141,135,148,197,999
宮崎県,4507,日向入郷,5,112,169,156,177,147,223,357,1341,78,103,125,125,173,274,427,1305
鹿児島県,4601,鹿児島,1,2287,2684,2294,2280,2384,2179,2652,16760,1277,1386,1243,1117,1213,1421,2169,9826
鹿児島県,4601,鹿児島,2,4148,4467,3905,3402,3161,2657,2656,24396,3853,4221,3902,3186,2955,2886,3070,24073
鹿児島県,4601,鹿児島,3,1649,1727,1557,1350,1212,1020,924,9439,1591,1712,1528,1454,1315,1332,1427,10359
鹿児島県,4601,鹿児島,4,1339,1533,1263,1103,1048,922,1075,8283,1013,1246,1196,1071,1024,1263,1550,8363
鹿児島県,4601,鹿児島,5,1275,1852,1809,1781,1863,1966,2394,12940,693,942,1119,1169,1403,1874,2773,9973
鹿児島県,4603,南薩,1,414,405,460,506,655,825,1000,4265,198,228,209,270,351,515,784,2555
鹿児島県,4603,南薩,2,573,581,575,604,674,786,800,4593,495,518,560,621,706,863,977,4740
鹿児島県,4603,南薩,3,197,197,205,198,242,266,277,1582,182,204,212,245,324,416,452,2035
鹿児島県,4603,南薩,4,144,162,111,163,141,167,227,1115,114,143,157,166,222,299,302,1403
鹿児島県,4603,南薩,5,130,199,208,217,278,386,558,1976,93,134,149,163,282,493,766,2080
鹿児島県,4605,川薩,1,500,536,543,631,659,688,968,4525,238,288,294,296,354,478,772,2720
鹿児島県,4605,川薩,2,664,703,577,586,612,657,765,4564,633,691,644,642,696,770,773,4849
鹿児島県,4605,川薩,3,234,232,215,258,241,232,214,1626,251,234,259,258,310,339,317,1968
鹿児島県,4605,川薩,4,208,237,196,203,199,182,224,1449,141,169,202,211,218,253,318,1512
鹿児島県,4605,川薩,5,200,255,263,323,317,373,485,2216,105,126,186,230,256,437,666,2006
鹿児島県,4606,出水,1,317,338,341,357,421,428,530,2732,160,198,221,209,260,315,432,1795
鹿児島県,4606,出水,2,400,425,398,426,359,376,405,2789,432,442,431,451,421,493,461,3131
鹿児島県,4606,出水,3,157,154,167,146,141,155,142,1062,160,194,163,174,171,206,225,1293
鹿児島県,4606,出水,4,133,134,140,115,84,80,105,791,85,117,139,105,120,144,164,874
鹿児島県,4606,出水,5,133,147,155,167,173,231,311,1317,73,83,106,144,176,304,377,1263
鹿児島県,4607,姶良・伊佐,1,870,962,972,1021,1048,954,1155,6982,429,521,496,498,579,587,939,4049
鹿児島県,4607,姶良・伊佐,2,1461,1513,1356,1317,1256,1169,1333,9405,1330,1411,1379,1291,1303,1305,1541,9560
鹿児島県,4607,姶良・伊佐,3,538,547,452,459,441,483,553,3473,532,579,571,560,597,739,836,4414
鹿児島県,4607,姶良・伊佐,4,429,477,477,404,405,281,355,2828,317,410,456,412,375,354,453,2777
鹿児島県,4607,姶良・伊佐,5,422,625,687,706,683,639,929,4691,237,315,396,470,504,739,1130,3791
鹿児島県,4609,曽於,1,221,236,250,288,373,385,453,2206,104,127,132,160,212,242,334,1311
鹿児島県,4609,曽於,2,380,358,384,380,418,386,405,2711,326,321,301,411,432,425,405,2621
鹿児島県,4609,曽於,3,153,117,100,132,155,135,144,936,132,126,160,127,180,198,185,1108
鹿児島県,4609,曽於,4,111,108,91,98,111,102,72,693,76,83,98,95,97,120,152,721
鹿児島県,4609,曽於,5,84,122,143,133,165,178,265,1090,48,58,79,101,162,225,320,993
鹿児島県,4610,肝属,1,478,493,484,542,666,696,787,4146,234,229,268,267,356,448,610,2412
鹿児島県,4610,肝属,2,855,805,687,707,752,727,709,5242,661,795,735,752,853,803,867,5466
鹿児島県,4610,肝属,3,294,255,263,238,279,245,237,1811,287,310,302,301,354,349,355,2258
鹿児島県,4610,肝属,4,262,257,215,197,198,188,213,1530,204,201,242,240,213,244,269,1613
鹿児島県,4610,肝属,5,249,296,317,338,370,432,582,2584,121,164,196,227,316,537,723,2284
鹿児島県,4611,熊毛,1,107,149,150,177,173,213,233,1202,66,71,76,62,110,149,178,712
鹿児島県,4611,熊毛,2,212,222,219,236,234,225,217,1565,160,179,191,177,195,226,255,1383
鹿児島県,4611,熊毛,3,79,80,90,83,85,67,71,555,78,67,79,56,84,109,98,571
鹿児島県,4611,熊毛,4,70,73,73,54,53,55,52,430,53,50,60,49,56,62,70,400
鹿児島県,4611,熊毛,5,61,98,93,68,79,79,98,576,37,55,54,70,56,115,152,539
鹿児島県,4612,奄美,1,255,322,295,324,403,570,606,2775,137,172,148,137,231,315,427,1567
鹿児島県,4612,奄美,2,513,535,549,539,593,590,471,3790,538,558,508,523,628,710,625,4090
鹿児島県,4612,奄美,3,207,223,210,222,156,170,171,1359,237,231,225,210,250,245,255,1653
鹿児島県,4612,奄美,4,178,194,158,157,139,124,117,1067,144,191,177,155,148,194,203,1212
鹿児島県,4612,奄美,5,152,189,182,221,218,274,359,1595,119,101,128,160,185,370,441,1504
沖縄県,4701,北部,1,300,279,243,252,302,233,147,1756,129,139,140,148,139,126,90,911
沖縄県,4701,北部,2,461,500,386,340,273,175,92,2227,420,444,336,349,327,185,101,2162
沖縄県,4701,北部,3,244,249,161,154,140,80,37,1065,259,250,199,192,178,73,43,1194
沖縄県,4701,北部,4,203,232,165,131,104,63,31,929,204,214,147,171,133,74,39,982
沖縄県,4701,北部,5,172,224,211,203,212,151,76,1249,137,144,134,157,161,125,77,935
沖縄県,4702,中部,1,1294,1620,1384,1142,1077,878,769,8164,711,786,772,584,564,532,511,4460
沖縄県,4702,中部,2,2727,3005,2526,2025,1471,919,595,13268,2772,3111,2637,2035,1492,946,633,13626
沖縄県,4702,中部,3,1225,1362,1159,942,683,435,277,6083,1364,1635,1371,1065,830,574,421,7260
沖縄県,4702,中部,4,1046,1328,1054,772,580,355,232,5367,947,1226,1065,860,602,407,303,5410
沖縄県,4702,中部,5,1116,1577,1532,1412,1121,923,822,8503,750,1057,1026,913,829,757,800,6132
沖縄県,4703,南部,1,1846,2253,2113,1784,1742,1741,1900,13379,1200,1304,1139,1038,1009,1253,1555,8498
沖縄県,4703,南部,2,3872,4154,3596,2856,2306,1704,1523,20011,4028,4389,3958,3233,2595,2216,2006,22425
沖縄県,4703,南部,3,1870,2112,1830,1421,1122,905,706,9966,2082,2409,2295,1786,1465,1359,1158,12554
沖縄県,4703,南部,4,1529,1862,1503,1159,837,652,539,8081,1499,1761,1698,1249,1075,918,764,8964
沖縄県,4703,南部,5,2043,2601,2639,2397,2050,2080,2317,16127,1525,1778,1922,1833,1819,2087,2391,13355
沖縄県,4704,宮古,1,101,127,97,142,198,261,273,1199,72,61,53,78,125,192,276,857
沖縄県,4704,宮古,2,330,370,303,320,302,278,160,2063,307,300,244,287,327,261,194,1920
沖縄県,4704,宮古,3,104,101,111,118,101,108,95,738,115,121,106,113,123,143,95,816
沖縄県,4704,宮古,4,99,106,75,67,50,45,36,478,101,114,90,88,90,76,61,620
沖縄県,4704,宮古,5,131,152,148,152,230,213,224,1250,114,107,121,116,162,230,212,1062
沖縄県,4705,八重山,1,90,107,98,83,107,134,154,773,82,66,63,58,71,110,135,585
沖縄県,4705,八重山,2,151,171,140,111,121,151,130,975,142,171,119,115,123,143,132,945
沖縄県,4705,八重山,3,75,78,87,57,64,73,64,498,91,70,72,76,98,116,134,657
沖縄県,4705,八重山,4,45,54,50,32,34,20,32,267,56,62,40,47,37,32,24,298
沖縄県,4705,八重山,5,172,172,166,149,219,272,320,1470,169,168,149,139,204,300,321,1450
二次医療圏判別不可,,,1,19840,21690,21079,19415,9662,2837,1735,96258,7203,8257,7794,6005,3360,1313,706,34638
二次医療圏判別不可,,,2,26468,26392,25268,22123,10781,2637,1317,114986,15314,17104,15801,11131,5336,1650,795,67131
二次医療圏判別不可,,,3,11550,11823,11599,10250,5120,1216,641,52199,6831,7749,7257,5355,2546,775,364,30877
二次医療圏判別不可,,,4,11149,11215,10155,9146,4279,1061,561,47566,4286,5077,4834,3724,1720,568,269,20478
二次医療圏判別不可,,,5,13225,16216,17489,17393,9026,2775,1961,78085,3382,4912,5625,4918,2447,1077,625,22986
