都道府県名,二次医療圏番号,二次医療圏名,回答,男40～44歳,男45～49歳,男50～54歳,男55～59歳,男60～64歳,男65～69歳,男70～74歳,男中計,女40～44歳,女45～49歳,女50～54歳,女55～59歳,女60～64歳,女65～69歳,女70～74歳,女中計
北海道,0101,南渡島,はい,2911,3665,3237,3037,2876,2847,3269,21842,2030,2490,2504,2370,2447,2872,3861,18574
北海道,0101,南渡島,いいえ,1581,2081,1935,1640,1366,921,876,10400,1474,2105,2114,1783,1421,1157,1295,11349
北海道,0102,南檜山,はい,191,244,226,209,233,215,225,1543,114,143,142,141,169,190,279,1178
北海道,0102,南檜山,いいえ,82,106,104,96,69,47,51,555,94,94,106,101,86,78,85,644
北海道,0103,北渡島檜山,はい,272,287,263,263,245,268,291,1889,150,199,181,175,199,280,312,1496
北海道,0103,北渡島檜山,いいえ,124,162,166,127,112,76,67,834,97,123,106,138,102,71,108,745
北海道,0104,札幌,はい,25493,30178,28357,24859,22416,14375,8966,154644,19341,22280,20128,16840,13185,7965,6112,105851
北海道,0104,札幌,いいえ,11925,14535,14031,11865,8886,4541,2203,67986,10041,12795,13296,11093,7032,3352,1901,59510
北海道,0105,後志,はい,1752,2221,2029,1916,1798,1721,1844,13281,1152,1499,1369,1364,1309,1516,2057,10266
北海道,0105,後志,いいえ,758,1042,1055,917,689,515,445,5421,612,930,982,835,728,525,626,5238
北海道,0106,南空知,はい,1188,1657,1454,1512,1569,1483,1413,10276,879,1135,1145,1140,1200,1185,1538,8222
北海道,0106,南空知,いいえ,556,781,686,656,587,399,324,3989,451,697,729,654,523,398,428,3880
北海道,0107,中空知,はい,721,1045,952,985,946,906,1161,6716,625,774,704,738,769,987,1367,5964
北海道,0107,中空知,いいえ,330,470,460,421,374,285,280,2620,301,435,457,463,362,302,426,2746
北海道,0108,北空知,はい,198,286,263,301,301,294,359,2002,177,213,226,225,234,295,384,1754
北海道,0108,北空知,いいえ,77,94,88,99,100,78,86,622,93,88,110,105,99,91,131,717
北海道,0109,西胆振,はい,1551,2060,1867,1585,1532,1556,1960,12111,1094,1391,1345,1177,1187,1476,2190,9860
北海道,0109,西胆振,いいえ,614,919,803,714,555,410,444,4459,492,722,749,717,568,490,624,4362
北海道,0110,東胆振,はい,2377,2966,2527,2193,2024,2083,2354,16524,1431,1755,1434,1397,1366,1819,2517,11719
北海道,0110,東胆振,いいえ,1366,1685,1326,1198,840,558,512,7485,889,1084,1115,951,714,644,711,6108
北海道,0111,日高,はい,535,626,552,478,461,443,462,3557,340,428,367,337,373,392,475,2712
北海道,0111,日高,いいえ,189,281,241,202,163,96,82,1254,156,212,241,221,144,144,161,1279
北海道,0112,上川中部,はい,2982,3607,3249,2938,2821,1900,1338,18835,2134,2533,2320,1906,1591,1101,1028,12613
北海道,0112,上川中部,いいえ,1328,1706,1555,1340,1101,612,323,7965,1059,1402,1529,1226,840,420,345,6821
北海道,0113,上川北部,はい,462,601,558,551,555,417,419,3563,310,350,322,317,376,366,491,2532
北海道,0113,上川北部,いいえ,172,231,217,211,154,124,113,1222,158,203,185,183,150,132,140,1151
北海道,0114,富良野,はい,393,462,449,477,470,438,556,3245,314,394,387,344,346,421,631,2837
北海道,0114,富良野,いいえ,130,171,162,179,138,116,84,980,147,175,188,189,187,148,163,1197
北海道,0115,留萌,はい,359,477,464,421,400,375,388,2884,227,315,293,269,324,359,481,2268
北海道,0115,留萌,いいえ,122,198,180,159,151,102,71,983,129,162,189,181,147,123,159,1090
北海道,0116,宗谷,はい,650,806,702,661,613,560,487,4479,430,469,386,389,366,382,483,2905
北海道,0116,宗谷,いいえ,229,326,279,269,233,169,117,1622,196,223,262,221,192,148,126,1368
北海道,0117,北網,はい,1906,2492,2223,2026,2007,1558,1770,13982,1385,1700,1454,1453,1431,1470,1958,10851
北海道,0117,北網,いいえ,838,976,865,852,697,409,345,4982,655,855,900,904,708,536,629,5187
北海道,0118,遠紋,はい,562,705,686,695,607,505,646,4406,324,390,413,396,422,512,768,3225
北海道,0118,遠紋,いいえ,193,265,257,225,202,156,129,1427,161,228,270,267,200,194,219,1539
北海道,0119,十勝,はい,3323,3983,3616,3433,3359,2976,3258,23948,2375,2926,2618,2509,2432,2679,3523,19062
北海道,0119,十勝,いいえ,1264,1663,1501,1373,1114,768,663,8346,1069,1454,1628,1447,1174,973,989,8734
北海道,0120,釧路,はい,2152,2714,2546,2302,2240,2070,2215,16239,1408,1841,1687,1511,1587,1852,2264,12150
北海道,0120,釧路,いいえ,965,1212,1115,958,866,527,491,6134,868,1092,1128,1028,820,719,706,6361
北海道,0121,根室,はい,684,765,653,638,571,485,486,4282,460,501,483,434,434,465,485,3262
北海道,0121,根室,いいえ,261,342,288,263,215,154,114,1637,251,274,271,260,217,167,151,1591
青森県,0201,津軽地域,はい,2579,2831,2648,2588,2537,1888,1721,16792,1897,2240,2071,2204,1951,1662,1755,13780
青森県,0201,津軽地域,いいえ,1259,1408,1321,1197,871,508,385,6949,1178,1341,1431,1374,915,604,495,7338
青森県,0202,八戸地域,はい,3921,4654,4512,4088,4115,3588,3548,28426,2757,3422,3325,3038,3167,3257,3681,22647
青森県,0202,八戸地域,いいえ,1941,2433,2535,2175,1771,1093,874,12822,1598,2134,2332,2030,1536,1188,1150,11968
青森県,0203,青森地域,はい,3620,4428,4131,4006,3962,3185,3701,27033,2713,3299,2980,3024,3040,3218,4273,22547
青森県,0203,青森地域,いいえ,1740,2117,1979,1794,1448,947,828,10853,1696,2093,2010,1806,1395,1094,1306,11400
青森県,0204,西北五地域,はい,886,1081,1096,1159,1071,1219,1364,7876,696,870,978,1014,1196,1478,1688,7920
青森県,0204,西北五地域,いいえ,383,510,490,506,370,297,291,2847,402,482,545,574,526,483,489,3501
青森県,0205,上十三地域,はい,1961,2335,2144,2056,2080,1866,1968,14410,1403,1725,1570,1521,1710,1853,2136,11918
青森県,0205,上十三地域,いいえ,1007,1068,1018,794,697,513,430,5527,761,939,1013,861,688,605,618,5485
青森県,0206,下北地域,はい,611,768,711,728,778,713,742,5051,463,588,578,518,621,715,754,4237
青森県,0206,下北地域,いいえ,303,345,322,304,256,209,168,1907,281,373,384,335,293,244,259,2169
岩手県,0301,盛岡,はい,6338,7355,6652,5992,6104,5415,6172,44028,4650,5473,4861,4495,4926,5589,7009,37003
岩手県,0301,盛岡,いいえ,3208,3698,3627,3182,2479,1599,1386,19179,2742,3377,3471,3056,2332,1914,2055,18947
岩手県,0302,岩手中部,はい,2912,3225,2711,2661,2553,2646,2923,19631,1896,2254,2026,1940,2105,2668,3320,16209
岩手県,0302,岩手中部,いいえ,1699,1923,1785,1630,1262,851,705,9855,1282,1571,1530,1422,1156,953,978,8892
岩手県,0303,胆江,はい,1635,1896,1574,1495,1702,1835,1999,12136,1167,1333,1140,1174,1420,1823,2278,10335
岩手県,0303,胆江,いいえ,1012,1157,963,977,801,587,491,5988,769,890,852,845,753,635,698,5442
岩手県,0304,両磐,はい,1361,1501,1321,1320,1475,1524,1708,10210,924,1055,1012,1048,1252,1489,1727,8507
岩手県,0304,両磐,いいえ,780,902,829,854,714,556,473,5108,647,789,757,776,666,601,518,4754
岩手県,0305,気仙,はい,558,765,771,775,709,707,847,5132,429,523,535,579,582,773,965,4386
岩手県,0305,気仙,いいえ,265,358,372,371,279,225,176,2046,246,352,391,397,327,304,290,2307
岩手県,0306,釜石,はい,413,493,493,456,426,460,484,3225,248,346,318,317,371,436,631,2667
岩手県,0306,釜石,いいえ,218,284,286,292,215,175,150,1620,217,215,247,250,211,175,194,1509
岩手県,0307,宮古,はい,692,783,903,855,805,889,1165,6092,473,599,598,587,746,958,1282,5243
岩手県,0307,宮古,いいえ,411,457,522,510,377,294,295,2866,321,408,474,396,374,344,407,2724
岩手県,0308,久慈,はい,565,693,710,630,791,739,866,4994,400,511,583,510,652,802,950,4408
岩手県,0308,久慈,いいえ,278,324,337,298,266,187,198,1888,281,310,350,303,299,255,267,2065
岩手県,0309,二戸,はい,507,623,633,691,732,841,911,4938,420,463,547,525,653,868,1036,4512
岩手県,0309,二戸,いいえ,309,341,371,355,302,267,215,2160,274,325,404,359,329,286,282,2259
宮城県,0401,仙南,はい,1864,2041,1783,1789,1986,2362,2728,14553,1305,1596,1379,1465,1743,2312,2557,12357
宮城県,0401,仙南,いいえ,1129,1258,1154,960,838,752,704,6795,905,1072,1077,1031,922,866,905,6778
宮城県,0403,仙台,はい,20585,24247,22000,18065,16409,15799,18594,135699,16288,18516,16078,13850,13964,15653,20404,114753
宮城県,0403,仙台,いいえ,10986,12948,12234,9902,7276,4872,4515,62733,9483,11843,11698,9413,7236,6042,6807,62522
宮城県,0406,大崎・栗原,はい,3201,3372,2837,2951,3381,3546,3710,22998,2269,2429,2213,2252,2732,3304,3526,18725
宮城県,0406,大崎・栗原,いいえ,1854,1937,1696,1635,1462,1254,1156,10994,1506,1835,1733,1688,1582,1509,1428,11281
宮城県,0409,石巻・登米・気仙沼,はい,3546,3953,3670,3541,3830,4324,5181,28045,2526,2946,2725,2981,3508,4377,5413,24476
宮城県,0409,石巻・登米・気仙沼,いいえ,1855,2137,1983,1860,1637,1369,1389,12230,1574,1857,2034,2027,1845,1703,1879,12919
秋田県,0501,大館・鹿角,はい,855,979,847,920,966,984,1202,6753,629,727,671,704,863,1070,1446,6110
秋田県,0501,大館・鹿角,いいえ,344,418,456,439,415,301,292,2665,391,390,455,433,389,347,412,2817
秋田県,0502,北秋田,はい,186,270,231,281,273,363,428,2032,138,163,161,177,253,369,492,1753
秋田県,0502,北秋田,いいえ,109,113,116,143,108,97,96,782,77,108,118,118,106,108,113,748
秋田県,0503,能代・山本,はい,693,818,795,810,888,915,1002,5921,518,647,703,684,830,961,1250,5593
秋田県,0503,能代・山本,いいえ,302,368,380,354,322,235,214,2175,312,366,423,419,371,321,290,2502
秋田県,0504,秋田周辺,はい,3481,4221,3904,3680,3476,3428,4153,26343,2676,3032,2902,2697,3099,3927,5192,23525
秋田県,0504,秋田周辺,いいえ,1580,1998,1901,1852,1584,988,906,10809,1464,1848,1927,1640,1363,1185,1408,10835
秋田県,0505,由利本荘・にかほ,はい,873,903,895,867,1009,1159,1270,6976,660,711,695,757,923,1246,1328,6320
秋田県,0505,由利本荘・にかほ,いいえ,451,503,476,504,372,327,297,2930,419,520,576,510,440,422,378,3265
秋田県,0506,大仙・仙北,はい,928,1058,986,980,1180,1425,1792,8349,769,807,822,856,1170,1744,2038,8206
秋田県,0506,大仙・仙北,いいえ,416,430,439,454,402,307,315,2763,368,417,422,465,493,498,436,3099
秋田県,0507,横手,はい,950,1011,909,938,1032,1147,1357,7344,767,915,882,846,1008,1352,1480,7250
秋田県,0507,横手,いいえ,340,383,354,372,343,239,224,2255,343,375,418,434,392,376,297,2635
秋田県,0508,湯沢・雄勝,はい,556,571,601,641,762,916,989,5036,407,455,504,519,668,923,1042,4518
秋田県,0508,湯沢・雄勝,いいえ,200,234,250,265,216,165,165,1495,136,220,258,242,241,213,206,1516
山形県,0601,村山,はい,7076,7421,6672,6423,6446,6565,7108,47711,5495,5801,5066,5045,5720,6203,6553,39883
山形県,0601,村山,いいえ,4497,4946,4564,4003,3748,2952,2776,27486,4240,4862,4775,4398,3789,3204,2954,28222
山形県,0602,最上,はい,1002,1181,1017,1101,1353,1389,1435,8478,795,941,961,1017,1337,1481,1421,7953
山形県,0602,最上,いいえ,386,370,355,397,303,218,175,2204,354,388,397,387,297,188,133,2144
山形県,0603,置賜,はい,3092,3411,3135,2999,3132,3218,3519,22506,2376,2636,2486,2577,2780,3228,3338,19421
山形県,0603,置賜,いいえ,1388,1553,1498,1393,1186,861,646,8525,1248,1450,1481,1353,1125,769,661,8087
山形県,0604,庄内,はい,3906,4413,4051,4024,4347,4570,4979,30290,3252,3698,3451,3490,4042,4751,5317,28001
山形県,0604,庄内,いいえ,1714,1871,1831,1607,1434,976,806,10239,1563,1814,1935,1850,1512,1114,1070,10858
福島県,0701,県北,はい,5887,6711,6233,5813,6027,6031,7097,43799,4580,5265,4793,4611,5190,5927,7147,37513
福島県,0701,県北,いいえ,3032,3759,3514,3284,2635,1816,1626,19666,2619,3270,3591,3192,2599,2176,2158,19605
福島県,0702,県中,はい,6215,6980,6125,5683,5941,5664,6091,42699,4903,5358,4733,4731,5198,5637,6604,37164
福島県,0702,県中,いいえ,3189,3641,3217,2894,2344,1485,1287,18057,2698,3295,3285,3015,2430,1787,1766,18276
福島県,0703,県南,はい,1861,1993,1717,1815,1897,2021,2115,13419,1393,1500,1252,1307,1676,1892,2144,11164
福島県,0703,県南,いいえ,1062,1149,995,948,744,550,503,5951,822,982,930,836,847,702,598,5717
福島県,0706,相双,はい,1468,1701,1439,1466,1772,2190,2541,12577,1076,1176,1145,1208,1694,2240,2564,11103
福島県,0706,相双,いいえ,668,797,728,689,649,686,748,4965,564,729,748,764,860,880,992,5537
福島県,0707,いわき,はい,3868,4535,4230,3730,3583,3247,3404,26597,2810,3299,3044,2856,3020,2893,3447,21369
福島県,0707,いわき,いいえ,1748,2166,2042,1835,1370,922,718,10801,1418,1801,1822,1694,1347,974,927,9983
福島県,0708,会津・南会津,はい,2885,3292,3026,3234,3476,3620,4053,23586,2213,2592,2412,2664,3104,3812,4288,21085
福島県,0708,会津・南会津,いいえ,1543,1655,1527,1545,1363,1011,906,9550,1348,1585,1729,1675,1443,1168,1117,10065
茨城県,0801,水戸,はい,5479,6623,6127,5129,4548,3492,3066,34464,4002,4625,4286,3743,3202,3001,3049,25908
茨城県,0801,水戸,いいえ,2769,3303,3194,2618,1757,983,704,15328,2082,2717,2847,2374,1710,1096,888,13714
茨城県,0802,日立,はい,2041,2617,2635,2366,2193,2023,2423,16298,1617,2166,2209,1870,1846,2058,2701,14467
茨城県,0802,日立,いいえ,1493,1834,1810,1525,1176,791,684,9313,1169,1630,1879,1482,1103,875,920,9058
茨城県,0803,常陸太田・ひたちなか,はい,4199,5068,5078,4472,3907,3702,4084,30510,2869,3503,3537,3001,3158,3600,4208,23876
茨城県,0803,常陸太田・ひたちなか,いいえ,2166,2695,2789,2342,1609,1015,905,13521,1620,2043,2347,1976,1477,1228,1231,11922
茨城県,0804,鹿行,はい,3062,3628,3254,2604,2256,2070,1887,18761,2014,2298,2200,1824,1769,1761,1920,13786
茨城県,0804,鹿行,いいえ,1605,2006,1750,1421,1046,646,509,8983,1159,1450,1471,1211,996,710,699,7696
茨城県,0805,土浦,はい,2938,3694,3411,2897,2464,2501,2629,20534,1990,2499,2320,2037,2030,2237,2808,15921
茨城県,0805,土浦,いいえ,1651,1932,1898,1569,1069,730,641,9490,1114,1604,1655,1367,1102,817,887,8546
茨城県,0806,つくば,はい,5152,5493,4680,3647,3078,2741,3096,27887,3810,4177,3398,2618,2417,2605,3152,22177
茨城県,0806,つくば,いいえ,2397,2597,2283,1808,1200,706,711,11702,1778,2167,2054,1675,1172,951,895,10692
茨城県,0807,取手・竜ヶ崎,はい,5234,6686,6103,5033,4382,4378,5543,37359,3951,4791,4313,3623,3708,4326,5494,30206
茨城県,0807,取手・竜ヶ崎,いいえ,2916,3641,3461,2747,1901,1350,1298,17314,2100,2807,2907,2495,1799,1488,1737,15333
茨城県,0808,筑西・下妻,はい,2822,3340,3006,2533,2557,2712,2582,19552,2019,2397,2286,2037,2237,2632,2681,16289
茨城県,0808,筑西・下妻,いいえ,1484,1766,1615,1409,1102,755,583,8714,1097,1474,1552,1382,1087,910,758,8260
茨城県,0809,古河・坂東,はい,2381,2736,2629,2083,1993,1556,1340,14718,1610,2010,1887,1519,1447,1356,1281,11110
茨城県,0809,古河・坂東,いいえ,1359,1599,1579,1307,966,510,322,7642,867,1190,1261,1019,865,548,419,6169
栃木県,0901,県北,はい,4905,5369,4926,4300,4503,4703,5304,34010,3396,3841,3573,3327,3765,4532,5223,27657
栃木県,0901,県北,いいえ,2460,2828,2517,2081,1629,1383,1235,14133,1707,2150,2246,1891,1726,1587,1504,12811
栃木県,0902,県西,はい,1827,2353,2246,1995,2057,2059,2330,14867,1389,1730,1687,1534,1684,2057,2511,12592
栃木県,0902,県西,いいえ,931,1187,1198,995,769,554,510,6144,725,1001,1044,956,786,611,651,5774
栃木県,0903,宇都宮,はい,8099,9094,8470,6852,5570,4291,4514,46890,5591,6351,5608,4386,3907,3818,4793,34454
栃木県,0903,宇都宮,いいえ,3898,4551,4172,3305,2110,1107,959,20102,2719,3361,3405,2742,1840,1324,1312,16703
栃木県,0904,県東,はい,2157,2379,1979,1789,1869,2073,2279,14525,1361,1578,1422,1254,1615,1980,2232,11442
栃木県,0904,県東,いいえ,1049,1205,1080,956,754,634,514,6192,709,888,864,830,744,727,657,5419
栃木県,0905,県南,はい,5821,7237,6358,5367,5293,5206,5687,40969,4261,4976,4740,3947,4276,4883,5651,32734
栃木県,0905,県南,いいえ,2985,3838,3483,2905,2063,1458,1229,17961,2249,2866,3070,2486,2014,1706,1699,16090
栃木県,0906,両毛,はい,2806,3500,3362,2848,2522,2404,2886,20328,1863,2324,2228,2011,2072,2422,3225,16145
栃木県,0906,両毛,いいえ,1558,1863,1818,1554,1112,739,657,9301,973,1383,1496,1273,943,867,876,7811
群馬県,1001,前橋,はい,4558,5363,5020,4211,3894,3725,4294,31065,3101,3918,3680,3277,3196,3703,4828,25703
群馬県,1001,前橋,いいえ,2075,2557,2466,2042,1515,1049,933,12637,1534,2064,2257,2023,1444,1268,1422,12012
群馬県,1002,渋川,はい,1355,1549,1474,1250,1376,1330,1510,9844,933,1097,1127,950,1070,1250,1646,8073
群馬県,1002,渋川,いいえ,638,749,663,595,558,375,303,3881,499,621,655,544,453,420,394,3586
群馬県,1003,伊勢崎,はい,3129,3859,3655,3056,2873,2556,3057,22185,2327,2721,2627,2228,2132,2555,3618,18208
群馬県,1003,伊勢崎,いいえ,1793,2136,2029,1707,1101,714,664,10144,1212,1704,1822,1388,1028,883,976,9013
群馬県,1004,高崎・安中,はい,5347,6636,6547,5296,4513,4175,4895,37409,3754,4782,4537,3822,3526,4117,5765,30303
群馬県,1004,高崎・安中,いいえ,2618,3364,3258,2652,1864,1206,1147,16109,1904,2719,2976,2498,1748,1512,1688,15045
群馬県,1005,藤岡,はい,696,911,850,766,734,741,968,5666,474,623,652,575,601,735,1073,4733
群馬県,1005,藤岡,いいえ,373,547,491,402,301,197,222,2533,224,403,421,365,292,257,287,2249
群馬県,1006,富岡,はい,670,888,805,830,849,939,1126,6107,527,692,672,675,711,966,1238,5481
群馬県,1006,富岡,いいえ,389,462,472,431,367,317,265,2703,263,413,449,396,385,341,350,2597
群馬県,1007,吾妻,はい,464,679,659,646,767,827,955,4997,361,461,501,531,595,702,949,4100
群馬県,1007,吾妻,いいえ,224,270,319,291,262,195,222,1783,165,260,307,279,275,223,261,1770
群馬県,1008,沼田,はい,806,966,1022,955,1039,1200,1375,7363,584,792,764,800,980,1187,1430,6537
群馬県,1008,沼田,いいえ,311,457,443,455,388,305,273,2632,313,446,435,468,383,339,343,2727
群馬県,1009,桐生,はい,1658,2213,2158,1800,1688,1592,2327,13436,1133,1576,1587,1319,1375,1787,2679,11456
群馬県,1009,桐生,いいえ,863,1081,1168,943,732,523,522,5832,651,930,1086,886,725,604,764,5646
群馬県,1010,太田・館林,はい,5189,6149,5649,4472,3696,3683,5046,33884,3054,3974,3609,2937,2843,3797,5602,25816
群馬県,1010,太田・館林,いいえ,3039,3419,3239,2520,1538,1108,1198,16061,1706,2362,2392,1776,1403,1300,1641,12580
埼玉県,1101,南部,はい,10750,12512,12114,9328,6930,5539,6455,63628,7567,8733,8266,6419,5246,4863,7296,48390
埼玉県,1101,南部,いいえ,5870,6934,6809,5119,3171,1849,1732,31484,3953,5300,5488,4386,2737,1839,2387,26090
埼玉県,1102,南西部,はい,9719,11302,10940,8721,6591,5736,7489,60498,7447,8642,8146,6476,5117,5434,8711,49973
埼玉県,1102,南西部,いいえ,5338,6458,6368,4883,2828,1625,1647,29147,3784,4965,5405,4181,2516,1922,2620,25393
埼玉県,1103,東部,はい,13391,16901,15932,12011,9435,8938,12489,89097,10340,12670,11827,9140,7819,9522,15388,76706
埼玉県,1103,東部,いいえ,7433,9502,9273,6871,4319,2832,3124,43354,5460,7340,7983,6025,4176,3439,4908,39331
埼玉県,1104,さいたま,はい,18065,20998,20199,16192,12940,9583,10527,108504,13142,14801,14125,11222,8862,7960,10669,80781
埼玉県,1104,さいたま,いいえ,9425,11205,11193,8878,5953,3794,4448,54896,6738,8676,9500,7742,5377,4466,6216,48715
埼玉県,1105,県央,はい,6304,7979,7738,6280,5465,5303,7098,46167,4448,5631,5614,4532,4194,5040,8172,37631
埼玉県,1105,県央,いいえ,3626,4634,4659,3547,2358,1477,1480,21781,2328,3355,3754,2950,2075,1880,2468,18810
埼玉県,1106,川越比企,はい,9405,11843,10903,8709,8002,7613,10044,66519,6522,7949,7488,6310,6277,7407,10811,52764
埼玉県,1106,川越比企,いいえ,5577,6743,6789,5174,3439,2306,2261,32289,3543,4835,5233,4070,3081,2557,3052,26371
埼玉県,1107,西部,はい,8508,10776,10611,8804,7796,7213,9154,62862,6423,7906,7506,6452,5928,6712,9465,50392
埼玉県,1107,西部,いいえ,4789,6411,6420,5072,3424,2117,2012,30245,3523,4676,5179,4184,2990,2205,2748,25505
埼玉県,1108,利根,はい,6736,8435,7878,6364,6301,6694,8284,50692,4750,5862,5565,4765,5020,6455,9229,41646
埼玉県,1108,利根,いいえ,3822,5076,4730,3750,2806,1847,1784,23815,2582,3470,3611,3201,2528,2135,2601,20128
埼玉県,1109,北部,はい,5935,6988,6699,5543,5186,5152,5594,41097,4127,5076,4821,4310,4215,4702,5644,32895
埼玉県,1109,北部,いいえ,3215,3863,3725,3128,2279,1437,1210,18857,2311,3053,3230,2719,2188,1549,1595,16645
埼玉県,1110,秩父,はい,791,977,1031,965,1067,1135,1285,7251,572,749,745,761,873,1131,1253,6084
埼玉県,1110,秩父,いいえ,490,583,665,581,479,373,298,3469,351,534,586,504,435,352,375,3137
千葉県,1201,千葉,はい,11869,15203,15391,11819,9353,7130,9096,79861,8444,10631,10706,8160,6656,6755,10438,61790
千葉県,1201,千葉,いいえ,6188,8107,8537,6571,4028,2172,1964,37567,4554,6243,7001,5424,3453,2356,3099,32130
千葉県,1202,東葛南部,はい,22934,27822,27407,21150,15034,10615,11606,136568,17546,20853,19565,14794,10790,9320,12635,105503
千葉県,1202,東葛南部,いいえ,12742,15375,15497,11502,6765,3468,3009,68358,9239,11791,12910,9528,5876,3664,4048,57056
千葉県,1203,東葛北部,はい,17868,21059,19964,15378,12684,11059,14364,112376,13504,15669,14541,11538,9992,11213,16608,93065
千葉県,1203,東葛北部,いいえ,9463,11518,11145,8474,5206,3112,2745,51663,6880,8807,9260,7331,4773,3553,4400,45004
千葉県,1204,印旛,はい,7692,9243,8519,7012,6658,7068,8372,54564,5980,7038,6366,5411,5652,6588,8008,45043
千葉県,1204,印旛,いいえ,4401,5223,5247,3889,3024,2121,1958,25863,3222,4199,4411,3562,2928,2444,2631,23397
千葉県,1205,香取海匝,はい,2154,2664,2676,2430,2636,2946,3802,19308,1592,1841,2041,2029,2489,3210,4103,17305
千葉県,1205,香取海匝,いいえ,1206,1534,1545,1381,1246,1022,940,8874,866,1193,1356,1287,1325,1285,1340,8652
千葉県,1206,山武長生夷隅,はい,3784,4740,4645,4061,4323,4858,5875,32286,2679,3329,3463,3209,3745,4506,5553,26484
千葉県,1206,山武長生夷隅,いいえ,2047,2642,2631,2438,2001,1516,1474,14749,1587,2060,2350,2263,1940,1686,1767,13653
千葉県,1207,安房,はい,890,1129,1181,979,1035,1046,1228,7488,763,960,888,730,882,1048,1404,6675
千葉県,1207,安房,いいえ,454,605,636,517,455,336,311,3314,397,569,639,555,426,399,415,3400
千葉県,1208,君津,はい,3783,4549,4081,3261,3296,3778,4672,27420,2361,2847,2618,2326,2439,3392,4875,20858
千葉県,1208,君津,いいえ,1961,2483,2414,1994,1526,1147,1161,12686,1443,1834,2048,1633,1297,1353,1695,11303
千葉県,1209,市原,はい,2619,3371,3174,2549,2405,2996,3513,20627,1909,2404,2328,1935,2095,2779,3593,17043
千葉県,1209,市原,いいえ,1365,1829,1808,1417,1103,854,820,9196,1081,1460,1528,1295,1106,1062,1275,8807
東京都,1301,区中央部,はい,24891,27209,25610,20763,14042,7382,6727,126624,17778,18942,16181,11736,8003,5784,7399,85823
東京都,1301,区中央部,いいえ,12191,13583,12962,10330,6103,2468,1753,59390,9269,10196,10298,7320,4371,2292,2535,46281
東京都,1302,区南部,はい,18783,20960,20719,15805,11224,7711,9261,104463,14804,16430,14176,10535,8021,7492,10676,82134
東京都,1302,区南部,いいえ,9416,10812,10711,8145,4943,2628,2462,49117,8232,9476,9861,7058,4321,2942,3663,45553
東京都,1303,区西南部,はい,19730,21113,19755,16723,12360,8708,9990,108379,19193,20682,18393,14265,10848,9301,12743,105425
東京都,1303,区西南部,いいえ,9101,9568,8876,7592,4655,2498,2449,44739,9226,10543,10558,8260,5379,3473,4225,51664
東京都,1304,区西部,はい,18833,19678,18275,15041,11377,8490,9627,101321,16679,17745,15900,12715,10026,8670,11898,93633
東京都,1304,区西部,いいえ,9525,9904,9088,7296,4521,2548,2403,45285,8558,9588,9749,7737,5155,3208,3713,47708
東京都,1305,区西北部,はい,26566,29202,27333,22479,18282,14384,17089,155335,22122,24468,22817,18382,15900,15238,20923,139850
東京都,1305,区西北部,いいえ,14248,15099,14711,11757,7950,4889,4700,73354,11716,14057,14997,12611,8777,6246,7415,75819
東京都,1306,区東北部,はい,16216,19370,18611,14761,11835,10537,13938,105268,13227,15392,14496,11995,10341,10889,16628,92968
東京都,1306,区東北部,いいえ,8672,10411,10121,7995,5273,3387,3480,49339,6980,8776,9929,8319,5544,4182,4976,48706
東京都,1307,区東部,はい,23115,27185,27064,20659,14190,10849,13390,136452,18204,20706,19146,13973,10670,10778,16336,109813
東京都,1307,区東部,いいえ,11365,13412,13554,10316,6158,3695,3683,62183,9196,11270,12428,9041,5789,4265,5532,57521
東京都,1308,西多摩,はい,3615,4664,5085,4135,3773,4033,5898,31203,2756,3590,3665,3225,3188,4064,6544,27032
東京都,1308,西多摩,いいえ,2477,3177,3487,2869,1960,1454,1608,17032,1940,2656,3121,2602,1993,1784,2267,16363
東京都,1309,南多摩,はい,16646,20419,21240,17637,13674,12671,17838,120125,13515,16594,16494,13376,11883,13377,20949,106188
東京都,1309,南多摩,いいえ,9345,11657,12609,9921,6195,3683,4214,57624,7181,9533,10824,8761,5954,4870,6576,53699
東京都,1310,北多摩西部,はい,8043,9539,9398,8136,6499,5597,7447,54659,6114,7265,7151,5937,5182,5728,8777,46154
東京都,1310,北多摩西部,いいえ,4526,5340,5528,4743,2940,1722,1798,26597,3378,4141,4667,4021,2675,1955,2726,23563
東京都,1311,北多摩南部,はい,14565,15711,15668,13657,10219,8408,10775,89003,12399,13772,12992,10504,8761,8745,12495,79668
東京都,1311,北多摩南部,いいえ,7602,8375,8452,7011,4450,2529,2815,41234,6511,7571,8371,6872,4662,3333,4170,41490
東京都,1312,北多摩北部,はい,9237,10619,10609,9237,7617,6528,8582,62429,7569,8717,8674,7380,6535,6901,10134,55910
東京都,1312,北多摩北部,いいえ,4781,5639,5871,5078,3261,2042,2116,28788,3803,4782,5520,4880,3381,2525,3294,28185
東京都,1313,島しょ,はい,263,295,310,250,227,239,310,1894,226,262,239,168,212,244,301,1652
東京都,1313,島しょ,いいえ,97,126,110,140,89,107,96,765,115,104,125,96,96,102,120,758
神奈川県,1404,川崎北部,はい,12030,13637,13922,11500,7916,5517,5910,70432,9530,10740,10318,7923,5946,4785,6279,55521
神奈川県,1404,川崎北部,いいえ,6284,7189,7275,5968,3249,1578,1388,32931,4838,5816,6501,5108,3008,1784,1981,29036
神奈川県,1405,川崎南部,はい,11073,12514,11225,8204,5894,3927,3910,56747,7896,8224,7085,5228,3782,3018,3755,38988
神奈川県,1405,川崎南部,いいえ,5775,6685,6252,4745,2670,1377,954,28458,4228,4851,4889,3580,2108,1250,1252,22158
神奈川県,1406,横須賀・三浦,はい,6674,9115,9724,8414,7165,5750,7227,54069,5610,7338,7496,6028,5182,5439,7821,44914
神奈川県,1406,横須賀・三浦,いいえ,3544,5116,5461,4458,2994,1669,1494,24736,2671,3889,4641,3667,2494,1690,2028,21080
神奈川県,1407,湘南東部,はい,9542,11505,11501,9435,7250,5445,7543,62221,7350,8770,8195,6451,5302,5501,9121,50690
神奈川県,1407,湘南東部,いいえ,4728,6063,6354,5141,2991,1525,1660,28462,3458,4623,5122,3974,2529,1859,2751,24316
神奈川県,1408,湘南西部,はい,6298,7674,7854,6706,5643,4951,6909,46035,4523,5606,5375,4548,4091,4700,7411,36254
神奈川県,1408,湘南西部,いいえ,3617,4622,4664,3862,2425,1481,1485,22156,2482,3453,3774,2997,2099,1667,2228,18700
神奈川県,1409,県央,はい,10660,12904,13044,10421,8044,6410,8862,70345,6920,8785,8408,6644,5608,6053,10321,52739
神奈川県,1409,県央,いいえ,6112,7753,7663,6076,3684,1967,1996,35251,4045,5527,5912,4502,2947,2231,3194,28358
神奈川県,1410,相模原,はい,8449,10248,10192,8468,6524,5198,6260,55339,6030,7347,7133,5851,4812,4534,6597,42304
神奈川県,1410,相模原,いいえ,4951,6045,6263,4870,2943,1499,1396,27967,3377,4293,4796,3851,2420,1645,2174,22556
神奈川県,1411,県西,はい,3908,4748,4930,4330,3502,2702,3556,27676,2467,3089,3173,2516,2351,2639,3949,20184
神奈川県,1411,県西,いいえ,2189,2799,2886,2561,1539,834,855,13663,1423,1985,2143,1739,1262,949,1270,10771
神奈川県,1412,横浜,はい,49178,59195,61456,50840,38014,26952,28712,314347,36782,44411,44293,34635,26765,22386,28248,237520
神奈川県,1412,横浜,いいえ,26079,32320,33908,27168,16325,8061,6725,150586,19725,25298,28370,22043,13456,8052,8743,125687
新潟県,1501,下越,はい,2649,2896,2908,2739,2808,2990,3572,20562,1920,2288,2167,2119,2380,3023,3719,17616
新潟県,1501,下越,いいえ,1236,1520,1455,1368,1052,755,688,8074,1081,1369,1536,1326,1085,885,897,8179
新潟県,1502,新潟,はい,12551,15169,13543,11583,10579,9844,11201,84470,8978,10752,9390,8770,8490,9560,12398,68338
新潟県,1502,新潟,いいえ,6174,7332,6922,5811,4246,2703,2341,35529,4995,6408,6444,5251,3935,2791,3166,32990
新潟県,1503,県央,はい,3021,3650,3473,3035,2871,2796,2999,21845,2160,2659,2541,2301,2315,2726,3096,17798
新潟県,1503,県央,いいえ,1459,1715,1671,1462,1135,767,663,8872,1150,1576,1622,1474,1088,807,780,8497
新潟県,1504,中越,はい,6305,7267,6460,5729,5659,5265,6476,43161,4770,5648,5010,4669,4855,5571,7182,37705
新潟県,1504,中越,いいえ,2974,3449,3454,3132,2360,1559,1340,18268,2535,3254,3321,2888,2240,1606,1744,17588
新潟県,1505,魚沼,はい,2200,2440,2243,2049,2337,2672,3043,16984,1654,1859,1780,1726,1945,2464,2705,14133
新潟県,1505,魚沼,いいえ,906,1040,998,1055,969,799,758,6525,872,1054,1085,999,864,805,756,6435
新潟県,1506,上越,はい,2676,3263,3055,2789,2904,3129,3828,21644,1963,2517,2296,2205,2377,3044,3902,18304
新潟県,1506,上越,いいえ,2700,3129,2940,2677,2291,1457,1154,16348,2059,2640,2531,2262,1821,1211,1145,13669
新潟県,1507,佐渡,はい,670,682,720,731,818,834,1037,5492,458,526,527,526,680,803,1008,4528
新潟県,1507,佐渡,いいえ,237,302,350,319,294,245,267,2014,257,306,305,305,302,228,280,1983
富山県,1601,新川,はい,1480,1882,1733,1449,1396,1308,1569,10817,1073,1372,1374,1276,1193,1374,2100,9762
富山県,1601,新川,いいえ,871,1107,1123,899,729,461,422,5612,703,1029,976,854,600,515,637,5314
富山県,1602,富山,はい,6101,7748,7202,5656,5045,4284,4925,40961,4674,5795,5346,4457,4085,4246,5824,34427
富山県,1602,富山,いいえ,4490,5704,5368,4170,2898,1796,1537,25963,3229,4339,4357,3479,2498,1701,1836,21439
富山県,1603,高岡,はい,3145,4063,3575,3008,2714,2839,4480,23824,2108,2831,2667,2333,2526,3437,5684,21586
富山県,1603,高岡,いいえ,3058,4022,3774,2972,2232,1636,1539,19233,2192,3075,3181,2484,1960,1529,2077,16498
富山県,1604,砺波,はい,1246,1529,1379,1234,1279,1327,2074,10068,910,1114,1058,987,1184,1702,2484,9439
富山県,1604,砺波,いいえ,977,1331,1138,994,876,664,707,6687,833,1160,1121,1016,880,734,893,6637
石川県,1701,南加賀,はい,2790,3671,3183,2665,2327,2016,2794,19446,2168,2765,2626,2249,2167,2326,3458,17759
石川県,1701,南加賀,いいえ,1476,2004,1726,1421,1019,701,800,9147,1183,1671,1624,1414,993,729,960,8574
石川県,1702,石川中央,はい,9415,11710,10584,8318,7109,5868,7186,60190,7355,8947,8107,6529,6012,6244,8829,52023
石川県,1702,石川中央,いいえ,5074,6244,5800,4515,3291,2122,2159,29205,3924,5315,5184,4225,3185,2162,2730,26725
石川県,1703,能登中部,はい,1059,1338,1228,1086,1133,1222,1748,8814,785,1119,1006,987,1079,1579,2209,8764
石川県,1703,能登中部,いいえ,583,834,743,687,543,469,557,4416,475,680,661,652,583,490,651,4192
石川県,1704,能登北部,はい,438,609,554,608,675,785,1114,4783,368,471,488,480,615,860,1266,4548
石川県,1704,能登北部,いいえ,198,287,297,296,279,259,294,1910,192,241,287,305,289,259,382,1955
福井県,1801,福井・坂井,はい,4929,5784,5294,4509,3815,2621,2203,29155,3465,4187,3958,3316,2741,2010,1811,21488
福井県,1801,福井・坂井,いいえ,2527,3099,2988,2508,2053,1166,823,15164,1881,2556,2642,2311,1743,955,733,12821
福井県,1802,奥越,はい,666,788,648,624,645,646,658,4675,543,608,552,572,594,642,677,4188
福井県,1802,奥越,いいえ,326,366,391,348,314,256,213,2214,292,337,396,402,336,278,281,2322
福井県,1803,丹南,はい,2493,2846,2410,2093,1728,1308,1349,14227,1828,2030,1858,1552,1413,1275,1515,11471
福井県,1803,丹南,いいえ,1396,1633,1505,1240,991,570,471,7806,1014,1326,1378,1220,953,540,576,7007
福井県,1804,嶺南,はい,1671,1905,1739,1593,1566,1317,1419,11210,1049,1332,1140,1094,1037,1246,1574,8472
福井県,1804,嶺南,いいえ,707,863,889,793,666,504,437,4859,513,750,813,711,598,470,501,4356
山梨県,1901,中北,はい,5775,6723,6550,5685,4861,4325,4344,38263,4540,5525,5016,4421,4136,4027,4275,31940
山梨県,1901,中北,いいえ,3310,4149,4062,3576,2709,2492,2806,23104,2708,3677,4011,3678,3184,3274,4004,24536
山梨県,1902,峡東,はい,1526,1863,1906,1655,1560,1470,1556,11536,1275,1548,1498,1360,1308,1405,1509,9903
山梨県,1902,峡東,いいえ,795,1077,1134,935,811,694,841,6287,726,974,1188,1067,906,925,971,6757
山梨県,1903,峡南,はい,486,581,609,597,675,705,726,4379,373,482,485,518,530,596,760,3744
山梨県,1903,峡南,いいえ,325,401,440,444,421,416,525,2972,259,379,455,471,485,542,598,3189
山梨県,1904,富士・東部,はい,1887,2230,2468,2450,2193,2013,2049,15290,1472,1766,1935,1868,1873,1836,2017,12767
山梨県,1904,富士・東部,いいえ,1031,1223,1385,1311,1077,786,722,7535,782,1054,1320,1290,1033,877,766,7122
長野県,2001,佐久,はい,2600,2958,2861,2631,2599,2511,2936,19096,2091,2306,2237,2129,2180,2410,2995,16348
長野県,2001,佐久,いいえ,1286,1400,1370,1224,931,623,590,7424,949,1172,1301,1158,951,730,729,6990
長野県,2002,上小,はい,2212,2790,2646,2269,2094,1961,2270,16242,1664,2068,1980,1796,1868,1948,2542,13866
長野県,2002,上小,いいえ,1218,1604,1461,1205,854,623,484,7449,867,1221,1323,1140,867,660,660,6738
長野県,2003,諏訪,はい,2380,2944,2809,2344,2048,1907,2507,16939,1789,2359,2235,1888,1871,1921,2816,14879
長野県,2003,諏訪,いいえ,1190,1619,1641,1213,844,644,628,7779,967,1475,1498,1161,896,751,910,7658
長野県,2004,上伊那,はい,2536,3115,2850,2408,2346,2091,2630,17976,1970,2397,2196,1981,1986,2152,2865,15547
長野県,2004,上伊那,いいえ,1194,1574,1421,1230,946,676,631,7672,955,1381,1449,1187,935,747,879,7533
長野県,2005,飯伊,はい,2107,2408,2367,2138,1931,1926,1972,14849,1556,1861,1749,1664,1698,1856,1960,12344
長野県,2005,飯伊,いいえ,1024,1204,1167,1024,777,643,557,6396,852,1100,1136,1092,948,666,644,6438
長野県,2006,木曽,はい,274,357,341,404,368,443,572,2759,207,213,239,257,315,367,574,2172
長野県,2006,木曽,いいえ,125,169,186,183,131,142,165,1101,112,123,155,170,153,151,184,1048
長野県,2007,松本,はい,5619,6902,6624,5447,4424,3590,3572,36178,4107,5094,4755,3961,3577,3177,3643,28314
長野県,2007,松本,いいえ,2929,3612,3439,2698,1765,1129,970,16542,1991,2833,3063,2559,1796,1199,1141,14582
長野県,2008,大北,はい,695,879,858,799,724,741,918,5614,500,651,644,636,633,651,903,4618
長野県,2008,大北,いいえ,304,411,424,380,305,202,250,2276,232,398,432,411,309,234,263,2279
長野県,2009,長野,はい,7166,8907,8540,7192,6528,5794,7002,51129,5418,6723,6395,5677,5353,5998,8209,43773
長野県,2009,長野,いいえ,3725,4440,4469,3723,2635,1747,1776,22515,2599,3845,4177,3565,2543,2001,2331,21061
長野県,2010,北信,はい,1030,1176,1148,1151,1116,1168,1387,8176,826,988,949,962,1045,1117,1295,7182
長野県,2010,北信,いいえ,491,624,615,570,488,380,374,3542,448,633,603,641,499,415,413,3652
岐阜県,2101,岐阜,はい,8926,11135,10544,8418,6870,5057,5242,56192,6427,7996,7746,6264,5321,4556,5643,43953
岐阜県,2101,岐阜,いいえ,5638,6955,6812,5426,3709,2406,2312,33258,3738,5226,5617,4455,3084,2193,2450,26763
岐阜県,2102,西濃,はい,3965,4985,4552,3910,3625,3380,4153,28570,2836,3471,3393,3001,3021,3381,4776,23879
岐阜県,2102,西濃,いいえ,2835,3512,3500,2833,2099,1447,1324,17550,1748,2500,2541,2300,1863,1452,1597,14001
岐阜県,2103,中濃,はい,4526,5458,4864,4060,4181,4060,4725,31874,3132,3829,3718,3373,3507,3901,4688,26148
岐阜県,2103,中濃,いいえ,2455,3045,2980,2461,1846,1353,1358,15498,1506,2155,2309,2114,1814,1431,1441,12770
岐阜県,2104,東濃,はい,3988,4850,4647,4121,3772,3573,3868,28819,2848,3411,3416,3087,3193,3319,4391,23665
岐阜県,2104,東濃,いいえ,2216,2883,2848,2516,1835,1176,1172,14646,1438,2183,2409,2254,1877,1357,1506,13024
岐阜県,2105,飛騨,はい,1864,2329,2234,1970,1846,1778,2511,14532,1424,1858,1793,1653,1670,1979,2690,13067
岐阜県,2105,飛騨,いいえ,854,1058,1032,940,809,583,613,5889,680,912,1033,971,790,621,736,5743
静岡県,2201,賀茂,はい,469,620,711,609,602,629,811,4451,332,475,484,454,480,631,944,3800
静岡県,2201,賀茂,いいえ,194,297,368,334,237,203,176,1809,158,252,322,265,240,229,241,1707
静岡県,2202,熱海伊東,はい,609,942,1068,944,994,977,1622,7156,530,795,889,827,901,1124,2109,7175
静岡県,2202,熱海伊東,いいえ,317,506,549,505,418,338,392,3025,314,420,567,509,438,424,631,3303
静岡県,2203,駿東田方,はい,7964,9723,9232,7898,6566,5155,5352,51890,5497,6930,6516,5632,4973,4636,5665,39849
静岡県,2203,駿東田方,いいえ,4173,5231,5523,4495,3100,1715,1473,25710,2952,4081,4584,3837,2686,1878,2041,22059
静岡県,2204,富士,はい,5367,6223,6089,5077,4302,3666,4243,34967,3377,4239,4152,3584,3295,3464,4505,26616
静岡県,2204,富士,いいえ,2588,3343,3433,2848,2014,1244,1049,16519,1739,2442,2794,2431,1767,1294,1272,13739
静岡県,2205,静岡,はい,8728,11072,10973,8837,7773,6417,7625,61425,6538,8048,7820,6483,5866,5728,7564,48047
静岡県,2205,静岡,いいえ,4466,5868,6086,5119,3705,2403,2093,29740,3568,4826,5571,4719,3501,2436,2449,27070
静岡県,2206,志太榛原,はい,6120,7198,6634,5511,5237,4249,4632,39581,4469,5244,4711,4070,4002,3850,4821,31167
静岡県,2206,志太榛原,いいえ,2707,3451,3336,2950,2202,1473,1298,17417,2085,2784,3021,2714,2194,1511,1403,15712
静岡県,2207,中東遠,はい,7106,7957,6841,5828,5609,4902,5291,43534,5047,5606,4922,4157,4523,4559,5304,34118
静岡県,2207,中東遠,いいえ,3661,4160,3724,3090,2394,1507,1416,19952,2457,3185,3140,2747,2349,1826,1755,17459
静岡県,2208,西部,はい,12342,14272,13535,11313,10027,8123,9082,78694,8933,10412,9950,8004,7528,7164,8964,60955
静岡県,2208,西部,いいえ,6427,7602,7702,6412,4470,2582,2285,37480,4405,6054,6755,5475,4218,2988,2839,32734
愛知県,2302,海部,はい,3702,4916,4757,3620,2908,2594,3618,26115,2525,3370,3238,2538,2368,2660,4573,21272
愛知県,2302,海部,いいえ,2031,3023,3136,2352,1433,897,944,13816,1281,2023,2199,1745,1238,981,1434,10901
愛知県,2304,尾張東部,はい,6915,8147,7831,5962,4679,3674,5175,42383,5011,5782,5462,4140,3624,3826,6034,33879
愛知県,2304,尾張東部,いいえ,3412,4273,4282,3205,2146,1230,1282,19830,2381,3173,3407,2649,1779,1444,1958,16791
愛知県,2305,尾張西部,はい,6132,8002,7638,6137,4852,4715,6460,43936,4835,6156,5986,4909,4457,5080,8000,39423
愛知県,2305,尾張西部,いいえ,3397,4638,4747,3822,2465,1504,1715,22288,2329,3517,3914,3165,2172,1700,2373,19170
愛知県,2306,尾張北部,はい,8619,10854,10397,7878,6089,5436,7298,56571,5960,7552,7191,5473,4759,5607,8712,45254
愛知県,2306,尾張北部,いいえ,4942,6671,6592,5062,3203,1897,1896,30263,3180,4733,5092,3839,2569,1993,2720,24126
愛知県,2307,知多半島,はい,9109,11242,10056,8159,6566,5896,8092,59120,6457,7704,7212,5776,5348,5995,9192,47684
愛知県,2307,知多半島,いいえ,4553,5743,5653,4556,2992,1881,2086,27464,2988,4153,4367,3581,2597,2159,2894,22739
愛知県,2308,西三河北部,はい,9020,9858,9655,7976,6091,4002,5100,51702,5495,6434,6210,4597,3848,3971,5516,36071
愛知県,2308,西三河北部,いいえ,3205,3927,3970,2980,1960,1105,1168,18315,2064,2872,3010,2318,1589,1268,1542,14663
愛知県,2309,西三河南部西,はい,10030,11597,11347,9268,7297,5586,6963,62088,6899,8162,7845,6396,5147,5373,7289,47111
愛知県,2309,西三河南部西,いいえ,5199,6330,6466,5105,3242,1802,1959,30103,3510,4518,4893,3941,2554,1983,2230,23629
愛知県,2310,西三河南部東,はい,6315,7262,7074,5856,4899,4194,5401,41001,4660,5309,4867,4077,3874,4186,5701,32674
愛知県,2310,西三河南部東,いいえ,3048,3632,3573,2861,2036,1370,1586,18106,2133,2764,2861,2391,1874,1616,2008,15647
愛知県,2311,東三河北部,はい,552,668,600,565,619,658,931,4593,361,457,397,401,540,694,986,3836
愛知県,2311,東三河北部,いいえ,356,375,380,340,281,232,226,2190,190,267,290,302,295,255,302,1901
愛知県,2312,東三河南部,はい,8269,9769,9728,7817,6840,5455,6580,54458,5660,6807,6446,5505,5319,5412,7575,42724
愛知県,2312,東三河南部,いいえ,4026,5205,5071,4145,2851,1838,1820,24956,2578,3536,3980,3248,2621,2080,2502,20545
愛知県,2313,名古屋・尾張中部,はい,33476,37771,35995,28755,22197,16816,19447,194457,23058,26192,24680,19897,16610,15481,21023,146941
愛知県,2313,名古屋・尾張中部,いいえ,16987,20543,20721,16485,10779,6036,5375,96926,12036,15397,16681,13082,8728,5807,6778,78509
三重県,2401,北勢,はい,10953,14194,13625,11302,9226,7944,10824,78068,7655,9736,9392,7919,7301,8408,12665,63076
三重県,2401,北勢,いいえ,6010,7623,7749,6235,4100,2406,2306,36429,4055,5571,6047,4845,3388,2512,3082,29500
三重県,2402,中勢伊賀,はい,5186,6149,5716,4916,4907,4718,5845,37437,3736,4300,4279,3916,4303,4869,6671,32074
三重県,2402,中勢伊賀,いいえ,3000,3698,3724,2943,2250,1433,1194,18242,2240,3109,3098,2555,1995,1491,1644,16132
三重県,2403,南勢志摩,はい,4362,5558,5391,4876,4600,4751,6275,35813,3316,4343,4225,3918,4286,5513,7532,33133
三重県,2403,南勢志摩,いいえ,2976,3772,3700,3226,2442,1633,1605,19354,2190,3004,3237,2918,2256,1800,2238,17643
三重県,2404,東紀州,はい,563,767,750,669,686,845,1102,5382,402,515,537,546,674,889,1414,4977
三重県,2404,東紀州,いいえ,254,379,387,397,310,263,263,2253,207,294,351,371,343,289,391,2246
滋賀県,2501,大津,はい,4155,5101,4692,3983,3566,3117,3724,28338,3583,3960,3771,3270,3209,2955,3953,24701
滋賀県,2501,大津,いいえ,2621,3051,2992,2451,1734,1004,870,14723,2305,3022,3093,2400,1580,1007,1170,14577
滋賀県,2502,湖南,はい,4830,5380,4685,3705,2925,2530,3280,27335,3901,4313,3573,2645,2355,2652,3937,23376
滋賀県,2502,湖南,いいえ,2908,3459,3118,2380,1382,895,814,14956,2256,2852,2735,1910,1280,942,1244,13219
滋賀県,2503,甲賀,はい,1798,2129,1919,1644,1646,1597,1997,12730,1207,1357,1230,1156,1360,1497,2077,9884
滋賀県,2503,甲賀,いいえ,1201,1331,1314,1044,785,493,502,6670,869,1107,1063,980,834,643,710,6206
滋賀県,2504,東近江,はい,2858,3085,2723,2324,2216,2084,2505,17795,2039,2186,1931,1814,1911,2091,2656,14628
滋賀県,2504,東近江,いいえ,1821,2026,1810,1513,1204,760,692,9826,1364,1648,1624,1439,1135,878,866,8954
滋賀県,2505,湖東,はい,1848,2113,1848,1484,1453,1292,1380,11418,1290,1534,1357,1185,1213,1308,1548,9435
滋賀県,2505,湖東,いいえ,1232,1359,1202,964,715,425,368,6265,886,1060,1090,895,702,502,495,5630
滋賀県,2506,湖北,はい,1844,2132,1988,1678,1565,1414,1521,12142,1341,1539,1490,1389,1429,1433,1595,10216
滋賀県,2506,湖北,いいえ,1092,1313,1206,1111,841,504,461,6528,932,1105,1185,1036,772,615,560,6205
滋賀県,2507,湖西,はい,444,514,561,520,578,441,439,3497,372,435,474,477,502,425,519,3204
滋賀県,2507,湖西,いいえ,235,301,329,304,267,138,123,1697,210,276,311,324,233,157,156,1667
京都府,2601,丹後,はい,1041,1360,1315,1227,1219,1141,1365,8668,735,1048,1085,990,1044,1147,1393,7442
京都府,2601,丹後,いいえ,395,591,641,587,477,329,332,3352,401,593,632,633,519,373,413,3564
京都府,2602,中丹,はい,2150,2653,2373,1989,1981,1869,2365,15380,1497,1920,1827,1555,1725,1701,2616,12841
京都府,2602,中丹,いいえ,925,1254,1219,1106,829,530,591,6454,713,1118,1127,953,804,607,854,6176
京都府,2603,南丹,はい,1388,1606,1494,1245,1344,1389,1780,10246,1018,1228,1206,1136,1317,1337,1881,9123
京都府,2603,南丹,いいえ,808,963,919,858,676,467,438,5129,614,853,894,803,636,501,543,4844
京都府,2604,京都・乙訓,はい,16543,20107,19111,15286,13129,10059,12189,106424,13753,16066,14575,11958,10166,9236,12821,88575
京都府,2604,京都・乙訓,いいえ,9005,11184,11332,9105,6189,3483,3258,53556,7548,9648,10522,8553,5553,3685,4207,49716
京都府,2605,山城北,はい,4700,6173,5584,4441,3715,3606,5240,33459,3575,4625,4140,3393,3274,3999,6749,29755
京都府,2605,山城北,いいえ,2703,3742,3568,2651,1845,1210,1418,17137,2089,2928,2944,2422,1665,1440,2213,15701
京都府,2606,山城南,はい,1424,1737,1575,1224,1106,1074,1499,9639,1098,1288,1118,981,906,1045,1604,8040
京都府,2606,山城南,いいえ,830,1031,989,758,561,352,355,4876,615,849,811,656,485,426,539,4381
大阪府,2701,豊能,はい,11836,13905,13388,10179,7952,5583,6645,69488,8861,10600,9921,7388,5589,4932,6529,53820
大阪府,2701,豊能,いいえ,6500,7982,8150,6550,4233,2740,3138,39293,5101,6550,7390,5757,3780,3174,4669,36421
大阪府,2702,三島,はい,7966,10046,9522,6938,5642,4590,5937,50641,6254,7659,7051,5125,4448,4442,6629,41608
大阪府,2702,三島,いいえ,4555,5892,5882,4255,2922,1595,1580,26681,3464,4651,4940,3537,2432,1848,2248,23120
大阪府,2703,北河内,はい,9722,12726,12178,9456,7209,4479,3581,59351,7080,9083,8665,6559,4560,2956,2964,41867
大阪府,2703,北河内,いいえ,5834,7823,8177,6279,3972,1860,1193,35138,4135,5978,6677,4820,2674,1371,1166,26821
大阪府,2704,中河内,はい,6753,8679,8753,6746,5162,3618,4073,43784,4730,6323,6191,4940,3818,3268,4558,33828
大阪府,2704,中河内,いいえ,4414,5981,6247,4825,3143,1595,1259,27464,3207,4738,5399,4420,2936,1848,1649,24197
大阪府,2705,南河内,はい,4176,5345,5533,4649,4267,3622,4248,31840,3134,4260,4224,3596,3228,3276,4433,26151
大阪府,2705,南河内,いいえ,2518,3683,3952,3445,2444,1400,1181,18623,2028,2792,3381,2806,1863,1264,1443,15577
大阪府,2706,堺市,はい,7544,9982,9467,7015,5502,4728,6549,50787,6092,7568,6896,5404,4470,4991,8074,43495
大阪府,2706,堺市,いいえ,4498,6384,6475,4828,3295,1870,1821,29171,3520,5101,5444,4081,2705,2069,2740,25660
大阪府,2707,泉州,はい,7168,9473,9458,7404,6087,4897,5469,49956,5266,6974,6718,5327,4431,4386,5522,38624
大阪府,2707,泉州,いいえ,4353,6082,6397,5038,3298,1850,1552,28570,3270,4695,5328,4042,2600,1780,1945,23660
大阪府,2708,大阪市,はい,30306,35086,33874,25749,19091,11445,8830,164381,24957,27658,25173,19816,14139,8344,7406,127493
大阪府,2708,大阪市,いいえ,18341,21815,22183,16967,10592,5126,3155,98179,15998,19770,21205,16777,9723,4156,2986,90615
兵庫県,2801,神戸,はい,16393,20118,19491,15669,13851,11768,14249,111539,12955,15586,14608,12053,11106,11110,15138,92556
兵庫県,2801,神戸,いいえ,9680,12256,12499,10191,7407,4483,4221,60737,7723,10139,10788,9025,6606,4651,5708,54640
兵庫県,2804,東播磨,はい,8512,9894,9149,7089,6086,5311,6256,52297,5569,6784,6222,4932,4423,4884,6627,39441
兵庫県,2804,東播磨,いいえ,4587,5648,5744,4465,3156,1800,1656,27056,3178,4162,4640,3528,2402,1781,2173,21864
兵庫県,2805,北播磨,はい,2557,3061,2852,2461,2288,2088,2488,17795,1819,2238,2093,1852,1815,2021,2496,14334
兵庫県,2805,北播磨,いいえ,1432,1882,1891,1664,1236,932,880,9917,1063,1466,1590,1425,1211,939,1036,8730
兵庫県,2808,但馬,はい,1717,2136,1934,1741,1989,1917,2227,13661,1243,1569,1546,1448,1635,1854,2200,11495
兵庫県,2808,但馬,いいえ,994,1202,1158,1072,955,780,799,6960,804,1132,1268,1252,1137,971,967,7531
兵庫県,2809,丹波,はい,1019,1202,1010,890,1049,1013,1182,7365,749,870,827,781,911,978,1092,6208
兵庫県,2809,丹波,いいえ,591,670,665,597,534,362,294,3713,415,539,590,603,565,397,419,3528
兵庫県,2810,淡路,はい,1174,1344,1291,1157,1230,1316,1538,9050,1001,1130,1019,961,1142,1329,1621,8203
兵庫県,2810,淡路,いいえ,579,808,743,716,647,545,559,4597,553,766,795,719,768,677,751,5029
兵庫県,2811,阪神,はい,17110,21842,21900,17342,13862,10636,12431,115123,13870,17316,16729,12891,10479,9385,12699,93369
兵庫県,2811,阪神,いいえ,9833,12998,13502,10963,7065,3807,3277,61445,7486,10499,11742,9098,5904,3791,4231,52751
兵庫県,2812,播磨姫路,はい,8864,11069,9816,8338,7492,6791,8596,60966,6006,7630,7058,6029,5796,6878,9816,49213
兵庫県,2812,播磨姫路,いいえ,4828,6007,5891,5024,3623,2389,2463,30225,3360,4861,4845,4224,3249,2694,3536,26769
奈良県,2901,奈良,はい,2967,3784,3858,3217,2869,2247,2369,21311,2563,3275,3216,2626,2151,2039,2439,18309
奈良県,2901,奈良,いいえ,1851,2409,2578,2217,1565,882,677,12179,1716,2224,2570,2054,1361,886,890,11701
奈良県,2902,東和,はい,1542,1918,1896,1629,1631,1554,2008,12178,1257,1500,1441,1360,1419,1634,2232,10843
奈良県,2902,東和,いいえ,973,1353,1366,1226,885,627,593,7023,857,1091,1281,1101,854,629,773,6586
奈良県,2903,西和,はい,3008,3905,3834,3064,2776,2563,3723,22873,2565,3167,2930,2450,2353,2922,4607,20994
奈良県,2903,西和,いいえ,2016,2677,2661,2167,1455,907,999,12882,1626,2210,2353,1868,1343,1085,1544,12029
奈良県,2904,中和,はい,3317,4170,4121,3368,2993,2727,3510,24206,2736,3161,3209,2785,2554,2892,4108,21445
奈良県,2904,中和,いいえ,2135,2766,2816,2354,1613,1027,923,13634,1666,2372,2576,2095,1499,1131,1361,12700
奈良県,2905,南和,はい,350,516,555,546,646,583,589,3785,315,409,409,498,568,536,624,3359
奈良県,2905,南和,いいえ,260,303,376,363,325,223,173,2023,237,329,328,382,320,214,201,2011
和歌山県,3001,和歌山,はい,4229,5333,5099,4270,3889,3406,4502,30728,2698,3524,3345,2978,2884,3408,5227,24064
和歌山県,3001,和歌山,いいえ,2124,2712,2612,2214,1662,1106,1108,13538,1527,1995,2290,2029,1458,1268,1752,12319
和歌山県,3002,那賀,はい,996,1291,1245,1087,1090,1076,1319,8104,742,934,1010,930,943,1092,1403,7054
和歌山県,3002,那賀,いいえ,521,704,705,599,472,298,277,3576,392,572,601,600,445,363,455,3428
和歌山県,3003,橋本,はい,650,872,774,747,806,917,1038,5804,507,695,636,654,796,862,1163,5313
和歌山県,3003,橋本,いいえ,338,458,459,447,407,263,289,2661,291,386,497,416,360,337,356,2643
和歌山県,3004,有田,はい,651,836,787,692,691,685,861,5203,570,633,710,610,643,747,852,4765
和歌山県,3004,有田,いいえ,313,382,348,336,250,197,194,2020,254,312,340,325,274,237,260,2002
和歌山県,3005,御坊,はい,659,820,722,643,715,728,773,5060,477,569,558,548,585,701,780,4218
和歌山県,3005,御坊,いいえ,308,392,361,355,246,180,192,2034,238,313,331,303,256,260,240,1941
和歌山県,3006,田辺,はい,1237,1603,1435,1304,1341,1177,1277,9374,991,1182,1103,1114,1124,1162,1402,8078
和歌山県,3006,田辺,いいえ,457,598,635,613,490,346,358,3497,461,583,663,695,531,422,508,3863
和歌山県,3007,新宮,はい,466,668,667,587,599,567,837,4391,322,428,469,476,538,664,951,3848
和歌山県,3007,新宮,いいえ,206,267,272,273,242,175,199,1634,181,223,253,271,228,249,332,1737
鳥取県,3101,東部,はい,2542,2934,2485,2263,2336,2270,2448,17278,1881,2144,1888,1831,1977,2246,2666,14633
鳥取県,3101,東部,いいえ,1553,1824,1545,1418,1171,857,764,9132,1360,1661,1627,1408,1222,1043,989,9310
鳥取県,3102,中部,はい,956,987,953,873,897,890,1000,6556,672,812,665,678,828,948,1132,5735
鳥取県,3102,中部,いいえ,557,658,568,560,514,392,301,3550,494,667,613,565,489,399,358,3585
鳥取県,3103,西部,はい,2534,2909,2618,2310,2297,2027,2202,16897,1909,2239,1877,1749,1779,1901,2525,13979
鳥取県,3103,西部,いいえ,1243,1502,1385,1252,1005,707,623,7717,1087,1346,1420,1245,1009,710,846,7663
島根県,3201,松江,はい,2970,3537,3261,2702,2678,2413,2739,20300,2342,2852,2562,2287,2204,2240,3050,17537
島根県,3201,松江,いいえ,1126,1375,1356,1132,913,725,810,7437,1049,1449,1418,1237,1101,958,1172,8384
島根県,3202,雲南,はい,656,795,625,601,738,734,824,4973,531,572,481,490,543,561,709,3887
島根県,3202,雲南,いいえ,257,341,294,278,313,295,340,2118,244,329,347,354,370,337,445,2426
島根県,3203,出雲,はい,2071,2440,2124,1886,1888,1742,2069,14220,1622,1875,1518,1475,1512,1743,2152,11897
島根県,3203,出雲,いいえ,955,1085,974,844,740,681,782,6061,873,1067,1044,975,881,852,959,6651
島根県,3204,大田,はい,590,675,587,555,644,634,737,4422,397,561,490,485,591,633,767,3924
島根県,3204,大田,いいえ,207,264,218,207,215,235,318,1664,215,231,230,229,283,302,394,1884
島根県,3205,浜田,はい,981,1157,999,941,1062,983,1185,7308,688,875,787,732,851,891,1238,6062
島根県,3205,浜田,いいえ,251,355,300,271,289,320,411,2197,280,332,332,329,344,414,551,2582
島根県,3206,益田,はい,736,866,647,680,767,869,1078,5643,488,617,528,514,636,853,1160,4796
島根県,3206,益田,いいえ,212,252,232,251,258,245,270,1720,230,283,266,274,274,282,388,1997
島根県,3207,隠岐,はい,283,271,210,213,213,265,294,1749,183,213,173,180,194,232,323,1498
島根県,3207,隠岐,いいえ,69,84,54,73,76,72,110,538,83,102,83,77,74,106,137,662
岡山県,3301,県南東部,はい,10404,12952,11354,9180,8395,7596,8352,68233,8154,9792,8866,7279,7169,7279,9402,57941
岡山県,3301,県南東部,いいえ,5717,7090,6469,5224,3885,2542,2424,33351,4539,5970,5998,5007,3760,2787,3257,31318
岡山県,3302,県南西部,はい,8178,10081,8875,6883,6341,5666,6348,52372,5747,7426,6547,5174,5118,5466,6820,42298
岡山県,3302,県南西部,いいえ,4194,5402,5095,3924,2834,2042,1655,25146,3295,4495,4497,3412,2622,1980,2326,22627
岡山県,3303,高梁・新見,はい,487,583,536,517,685,637,694,4139,364,442,371,403,549,621,666,3416
岡山県,3303,高梁・新見,いいえ,251,339,313,307,301,256,184,1951,203,280,278,301,319,231,246,1858
岡山県,3304,真庭,はい,456,521,424,439,537,506,647,3530,341,414,352,374,481,571,689,3222
岡山県,3304,真庭,いいえ,250,281,225,186,227,202,155,1526,214,200,222,273,229,197,185,1520
岡山県,3305,津山・英田,はい,1718,2054,1789,1418,1658,1645,1819,12101,1336,1610,1410,1218,1552,1608,1964,10698
岡山県,3305,津山・英田,いいえ,908,1121,990,754,684,529,570,5556,798,962,945,872,752,623,688,5640
広島県,3401,広島,はい,15078,18636,17679,14155,11295,6977,5075,88895,11108,13423,11939,9197,7020,4457,3842,60986
広島県,3401,広島,いいえ,10616,13602,13003,10045,6991,3515,2381,60153,7728,10317,10611,7955,5179,2792,2263,46845
広島県,3402,広島西,はい,1342,1619,1403,1287,1286,1128,1141,9206,1019,1188,1108,962,987,944,899,7107
広島県,3402,広島西,いいえ,883,1115,1113,943,758,457,327,5596,597,856,896,771,617,393,332,4462
広島県,3403,呉,はい,1692,2479,2204,2080,1837,1593,1789,13674,1306,1676,1627,1432,1400,1404,2006,10851
広島県,3403,呉,いいえ,1232,1839,1889,1488,1179,761,639,9027,942,1507,1447,1304,899,624,733,7456
広島県,3404,広島中央,はい,2751,3263,2909,2387,2063,1476,1561,16410,1628,2099,1899,1559,1461,1247,1478,11371
広島県,3404,広島中央,いいえ,1562,2001,1988,1590,1096,598,524,9359,954,1373,1352,1086,887,552,578,6782
広島県,3405,尾三,はい,2412,2968,2625,2198,2200,2046,2176,16625,1625,2089,1885,1723,1913,1908,2311,13454
広島県,3405,尾三,いいえ,1129,1513,1362,1194,1024,707,717,7646,843,1214,1272,1103,956,795,836,7019
広島県,3406,福山・府中,はい,6299,7509,6461,5192,4574,3782,3834,37651,4321,5316,4731,3775,3530,3356,3819,28848
広島県,3406,福山・府中,いいえ,2387,3061,2766,2200,1675,1028,866,13983,1674,2164,2309,1860,1371,957,978,11313
広島県,3407,備北,はい,782,912,811,769,844,919,1040,6077,647,782,684,686,758,905,1029,5491
広島県,3407,備北,いいえ,476,599,529,419,451,369,367,3210,385,483,495,451,498,415,419,3146
山口県,3501,岩国,はい,1121,1522,1408,1263,1253,1227,1437,9231,804,1109,1079,931,920,1171,1559,7573
山口県,3501,岩国,いいえ,547,747,798,656,528,338,351,3965,437,601,738,575,491,371,451,3664
山口県,3502,柳井,はい,668,911,833,662,709,731,727,5241,489,654,650,542,606,674,841,4456
山口県,3502,柳井,いいえ,332,446,390,331,311,199,187,2196,256,359,409,311,290,235,254,2114
山口県,3503,周南,はい,2680,3578,3362,2520,2257,2117,2584,19098,1863,2567,2333,1855,1817,2084,3135,15654
山口県,3503,周南,いいえ,1347,1802,1636,1261,978,602,700,8326,1010,1452,1472,1176,953,772,1030,7865
山口県,3504,山口・防府,はい,3744,4627,4027,3437,3221,2526,2590,24172,2334,2810,2622,2158,2191,2062,2457,16634
山口県,3504,山口・防府,いいえ,1868,2303,2169,1738,1393,846,767,11084,1361,1788,1761,1489,1131,842,882,9254
山口県,3505,宇部・小野田,はい,2676,3363,2837,2472,2303,1971,2188,17810,1782,2054,2030,1720,1693,1830,2403,13512
山口県,3505,宇部・小野田,いいえ,1276,1523,1488,1238,936,684,625,7770,934,1185,1321,1098,875,742,848,7003
山口県,3506,下関,はい,2445,3094,2665,2247,2079,1487,1002,15019,1655,2008,1928,1677,1449,946,743,10406
山口県,3506,下関,いいえ,1198,1534,1363,1174,884,537,256,6946,836,1172,1307,1159,808,413,304,5999
山口県,3507,長門,はい,354,428,341,274,351,325,372,2445,234,290,272,264,331,355,423,2169
山口県,3507,長門,いいえ,166,185,183,148,151,112,112,1057,140,157,192,163,171,133,141,1097
山口県,3508,萩,はい,427,560,506,475,525,576,610,3679,281,396,385,376,458,557,682,3135
山口県,3508,萩,いいえ,200,266,250,220,218,177,182,1513,157,227,270,241,218,237,269,1619
徳島県,3601,東部,はい,5115,5993,5332,4676,4526,4304,5309,35255,3852,4612,4206,3702,3941,4776,6061,31150
徳島県,3601,東部,いいえ,2588,3240,3196,2858,2138,1674,1830,17524,2430,3143,3299,2934,2219,2244,2543,18812
徳島県,3603,南部,はい,1448,1684,1427,1243,1266,1476,1984,10528,998,1097,1129,1023,1204,1515,2224,9190
徳島県,3603,南部,いいえ,648,840,820,772,628,526,684,4918,527,775,865,776,725,812,945,5425
徳島県,3605,西部,はい,568,636,609,625,725,869,1052,5084,410,487,504,552,715,908,1152,4728
徳島県,3605,西部,いいえ,309,326,336,350,372,383,379,2455,309,394,364,417,383,390,408,2665
香川県,3702,小豆,はい,219,239,188,218,197,232,376,1669,199,198,198,178,218,279,460,1730
香川県,3702,小豆,いいえ,105,102,137,107,115,114,136,816,98,144,134,144,129,160,182,991
香川県,3706,東部,はい,6072,7668,6894,5474,4889,4353,5354,40704,4674,5809,5154,4130,4063,4381,6339,34550
香川県,3706,東部,いいえ,2854,3713,3452,2871,2248,1535,1764,18437,2555,3504,3514,2795,2280,1860,2480,18988
香川県,3707,西部,はい,3859,4733,4179,3442,3497,3524,4451,27685,2911,3616,3163,2772,3066,3505,5057,24090
香川県,3707,西部,いいえ,1944,2404,2187,1951,1715,1251,1337,12789,1679,2228,2245,1955,1724,1548,1911,13290
愛媛県,3801,宇摩,はい,912,1129,941,863,688,522,511,5566,600,738,682,568,460,476,475,3999
愛媛県,3801,宇摩,いいえ,457,590,559,517,401,247,181,2952,367,470,482,431,337,267,223,2577
愛媛県,3802,新居浜・西条,はい,2237,2808,2389,2062,1818,1285,1316,13915,1563,1865,1653,1466,1264,1116,1329,10256
愛媛県,3802,新居浜・西条,いいえ,1262,1580,1408,1269,937,568,464,7488,955,1237,1246,1115,816,596,565,6530
愛媛県,3803,今治,はい,1614,2035,1765,1549,1364,1151,1421,10899,1173,1429,1339,1200,1142,1066,1509,8858
愛媛県,3803,今治,いいえ,898,1134,1148,826,757,532,517,5812,640,929,1046,787,662,494,577,5135
愛媛県,3804,松山,はい,7832,9510,8327,6739,6221,4366,3513,46508,5711,6772,6022,4972,4527,3588,3445,35037
愛媛県,3804,松山,いいえ,4105,5052,4775,4086,3070,1853,1213,24154,3543,4343,4511,3773,2843,1871,1457,22341
愛媛県,3805,八幡浜・大洲,はい,1302,1685,1407,1440,1470,1223,1265,9792,997,1159,1172,1128,1166,1204,1333,8159
愛媛県,3805,八幡浜・大洲,いいえ,646,775,789,824,734,485,429,4682,623,774,911,828,710,528,498,4872
愛媛県,3806,宇和島,はい,1034,1288,1173,1110,1074,946,1109,7734,799,1052,965,925,977,1037,1212,6967
愛媛県,3806,宇和島,いいえ,500,652,554,583,506,355,400,3550,468,660,741,704,644,513,577,4307
高知県,3901,安芸,はい,400,484,463,445,467,462,607,3328,274,368,333,338,423,561,793,3090
高知県,3901,安芸,いいえ,203,228,252,241,202,183,216,1525,153,214,257,261,223,255,313,1676
高知県,3902,中央,はい,5872,7268,6220,5215,4832,4504,5292,39203,4673,5684,5002,4378,4414,4554,6055,34760
高知県,3902,中央,いいえ,2836,3601,3237,2849,2288,1676,1704,18191,2591,3314,3505,2958,2363,1840,2148,18719
高知県,3903,高幡,はい,523,590,571,497,556,669,852,4258,346,436,416,418,513,690,850,3669
高知県,3903,高幡,いいえ,242,275,280,267,320,257,291,1932,183,275,256,276,281,275,338,1884
高知県,3904,幡多,はい,716,874,752,671,739,888,1144,5784,568,714,633,637,781,1065,1422,5820
高知県,3904,幡多,いいえ,328,424,368,320,371,310,341,2462,322,467,451,399,371,393,484,2887
福岡県,4001,福岡・糸島,はい,21586,23630,21259,16629,13854,11054,11929,119941,17581,18602,15759,12136,10177,9861,12114,96230
福岡県,4001,福岡・糸島,いいえ,9930,11079,10373,8194,5743,3541,2988,51848,8494,9966,10034,7921,5615,3745,4194,49969
福岡県,4002,粕屋,はい,4011,4678,3502,2639,2502,2178,2151,21661,2967,3212,2360,1874,1805,1783,1923,15924
福岡県,4002,粕屋,いいえ,1978,2283,1956,1346,1088,682,577,9910,1572,1842,1724,1307,1025,712,715,8897
福岡県,4003,宗像,はい,2027,2008,1651,1360,1478,1431,1496,11451,1551,1538,1280,1205,1228,1296,1458,9556
福岡県,4003,宗像,いいえ,900,934,798,677,600,370,329,4608,727,834,842,679,560,438,381,4461
福岡県,4004,筑紫,はい,5185,5983,5161,4182,3910,3467,3967,31855,4074,4589,4075,3365,3113,3171,4003,26390
福岡県,4004,筑紫,いいえ,2442,2909,2750,2137,1615,1043,876,13772,2095,2662,2699,2188,1578,1135,1262,13619
福岡県,4005,朝倉,はい,914,992,816,749,798,909,1048,6226,640,713,635,647,736,937,1107,5415
福岡県,4005,朝倉,いいえ,531,552,533,421,391,308,280,3016,400,516,512,480,394,339,354,2995
福岡県,4006,久留米,はい,4512,4998,4462,3898,3926,3656,4211,29663,3555,3949,3603,3268,3238,3609,4514,25736
福岡県,4006,久留米,いいえ,2332,2749,2428,2159,1690,1184,948,13490,1908,2499,2769,2280,1775,1426,1475,14132
福岡県,4007,八女・筑後,はい,1354,1474,1328,1205,1376,1367,1548,9652,987,1149,1045,1074,1196,1372,1685,8508
福岡県,4007,八女・筑後,いいえ,721,763,700,682,559,383,392,4200,619,720,857,773,597,516,512,4594
福岡県,4008,有明,はい,1765,1955,1864,1762,1924,1889,2361,13520,1299,1564,1419,1501,1617,2099,2807,12306
福岡県,4008,有明,いいえ,859,971,944,969,793,604,591,5731,753,932,1069,1051,831,705,867,6208
福岡県,4009,飯塚,はい,1751,1948,1553,1299,1668,1674,2174,12067,1421,1613,1301,1162,1473,1812,2493,11275
福岡県,4009,飯塚,いいえ,891,997,848,762,606,505,567,5176,814,1007,1008,818,802,674,816,5939
福岡県,4010,直方・鞍手,はい,1205,1196,967,822,955,995,1266,7406,768,760,779,659,788,1037,1351,6142
福岡県,4010,直方・鞍手,いいえ,543,629,533,463,453,318,339,3278,433,531,532,490,427,349,460,3222
福岡県,4011,田川,はい,1025,1198,1005,826,955,1039,1240,7288,819,926,805,785,888,1074,1327,6624
福岡県,4011,田川,いいえ,512,589,535,470,436,366,333,3241,473,624,614,555,472,465,488,3691
福岡県,4012,北九州,はい,11771,13457,12416,10143,9942,9445,11349,78523,8430,9895,9098,7973,7708,8777,12719,64600
福岡県,4012,北九州,いいえ,5616,6908,6253,5412,4315,2922,2861,34287,4565,5897,6651,5409,4043,3173,4167,33905
福岡県,4013,京築,はい,2043,2451,2138,1780,1823,1929,2262,14426,1407,1699,1447,1321,1470,1861,2366,11571
福岡県,4013,京築,いいえ,1022,1252,1178,1031,835,565,590,6473,782,1048,1157,910,785,711,874,6267
佐賀県,4101,中部,はい,3676,4101,3812,3454,3371,3424,3797,25635,2736,3116,2827,2682,2851,3296,3932,21440
佐賀県,4101,中部,いいえ,1983,2205,2035,1924,1561,1171,981,11860,1781,2199,2264,2065,1666,1296,1128,12399
佐賀県,4102,東部,はい,1589,1731,1420,1185,1170,1189,1488,9772,1002,1151,1021,793,960,1185,1678,7790
佐賀県,4102,東部,いいえ,865,905,795,680,497,380,361,4483,615,759,779,576,475,433,469,4106
佐賀県,4103,北部,はい,1183,1249,1052,1050,1151,1178,1337,8200,907,1040,835,895,1072,1209,1347,7305
佐賀県,4103,北部,いいえ,519,683,564,520,479,382,390,3537,567,650,663,686,592,474,466,4098
佐賀県,4104,西部,はい,910,903,812,780,813,882,952,6052,634,654,597,612,728,901,1182,5308
佐賀県,4104,西部,いいえ,379,394,391,372,328,259,253,2376,346,383,403,425,343,310,310,2520
佐賀県,4105,南部,はい,1353,1484,1372,1462,1490,1679,2066,10906,961,1063,1032,1066,1415,1805,2321,9663
佐賀県,4105,南部,いいえ,623,627,623,718,632,455,480,4158,513,653,701,731,637,621,671,4527
長崎県,4201,長崎,はい,5118,6279,6034,5386,5200,5197,6175,39389,4291,5014,4682,4374,4424,5193,6837,34815
長崎県,4201,長崎,いいえ,2070,2608,2739,2484,2044,1417,1531,14893,1995,2601,2837,2533,2088,1794,2138,15986
長崎県,4202,佐世保県北,はい,2405,2814,2546,2527,2565,2704,3282,18843,1967,2289,2183,1975,2219,2921,3727,17281
長崎県,4202,佐世保県北,いいえ,1045,1259,1190,1106,993,868,884,7345,1017,1181,1270,1203,1019,1018,1196,7904
長崎県,4203,県央,はい,2967,3272,2995,2846,2748,2737,3045,20610,2283,2461,2396,2193,2262,2801,3570,17966
長崎県,4203,県央,いいえ,1266,1607,1502,1255,1044,775,680,8129,1100,1337,1438,1321,1089,898,1011,8194
長崎県,4204,県南,はい,1122,1287,1259,1349,1397,1578,1910,9902,898,1100,1154,1200,1469,1800,2203,9824
長崎県,4204,県南,いいえ,383,450,491,477,576,376,415,3168,428,491,597,611,573,594,652,3946
長崎県,4206,五島,はい,282,341,332,337,347,427,480,2546,221,232,251,277,366,455,540,2342
長崎県,4206,五島,いいえ,120,118,130,128,153,150,126,925,107,127,156,148,175,186,177,1076
長崎県,4207,上五島,はい,228,268,235,256,288,296,288,1859,129,171,164,202,246,254,302,1468
長崎県,4207,上五島,いいえ,72,79,97,121,94,91,70,624,57,77,80,114,96,115,126,665
長崎県,4208,壱岐,はい,250,284,286,272,297,302,420,2111,215,235,184,235,259,338,457,1923
長崎県,4208,壱岐,いいえ,104,122,122,102,101,121,108,780,120,136,132,141,121,123,154,927
長崎県,4209,対馬,はい,281,338,304,287,374,411,454,2449,206,239,215,250,334,435,508,2187
長崎県,4209,対馬,いいえ,105,118,110,107,109,122,141,812,125,140,156,141,141,166,168,1037
熊本県,4302,宇城,はい,1086,1173,1152,1138,1113,1101,1116,7879,814,882,848,821,924,1005,1115,6409
熊本県,4302,宇城,いいえ,504,563,455,555,449,301,304,3131,455,540,579,529,456,375,336,3270
熊本県,4303,有明,はい,1581,1548,1424,1380,1430,1496,1630,10489,1129,1263,1145,1103,1267,1397,1647,8951
熊本県,4303,有明,いいえ,782,812,712,697,597,469,424,4493,635,799,765,771,658,486,514,4628
熊本県,4304,鹿本,はい,532,532,495,525,545,532,602,3763,368,406,426,400,456,503,555,3114
熊本県,4304,鹿本,いいえ,247,259,278,217,212,166,147,1526,222,251,271,268,238,192,199,1641
熊本県,4305,菊池,はい,2583,2714,2137,1967,1916,1777,1672,14766,1954,1894,1508,1424,1501,1492,1601,11374
熊本県,4305,菊池,いいえ,1379,1465,1127,991,730,506,427,6625,1186,1276,1140,1006,768,570,460,6406
熊本県,4306,阿蘇,はい,616,650,596,649,740,962,1108,5321,516,531,527,581,724,982,1088,4949
熊本県,4306,阿蘇,いいえ,284,302,270,315,288,286,219,1964,271,347,361,363,329,324,328,2323
熊本県,4308,八代,はい,1442,1608,1480,1398,1415,1331,1346,10020,1074,1268,1181,1219,1310,1375,1466,8893
熊本県,4308,八代,いいえ,699,761,731,740,557,405,384,4277,645,782,757,740,673,574,534,4705
熊本県,4309,芦北,はい,380,445,499,483,440,438,426,3111,272,302,295,329,370,421,393,2382
熊本県,4309,芦北,いいえ,187,192,209,247,228,175,119,1357,165,182,245,257,228,189,170,1436
熊本県,4310,球磨,はい,982,1044,1003,1092,1233,1300,1502,8156,812,893,884,915,1074,1280,1592,7450
熊本県,4310,球磨,いいえ,387,488,440,476,475,410,385,3061,418,499,505,551,513,474,517,3477
熊本県,4311,天草,はい,1090,1229,1196,1207,1468,1486,1620,9296,962,1089,1079,1221,1452,1662,1726,9191
熊本県,4311,天草,いいえ,474,539,560,556,561,509,437,3636,493,642,730,790,659,616,547,4477
熊本県,4312,熊本・上益城,はい,9323,10641,9280,8619,8205,7403,7430,60901,7637,8437,7333,6774,6640,6810,8026,51657
熊本県,4312,熊本・上益城,いいえ,4498,5152,4617,4180,3187,2080,1659,25373,4269,5363,5303,4668,3320,2437,2461,27821
大分県,4401,東部,はい,1700,2016,1872,1731,1926,2062,2540,13847,1494,1781,1777,1660,1799,2101,2965,13577
大分県,4401,東部,いいえ,862,1047,988,892,856,699,788,6132,884,1089,1182,1175,1063,933,1130,7456
大分県,4403,中部,はい,7436,8875,7489,6286,6489,6065,6346,48986,5960,6907,6180,5420,5452,5569,6920,42408
大分県,4403,中部,いいえ,2852,3378,3057,2646,2132,1406,1305,16776,2459,3077,3089,2505,2145,1722,1893,16890
大分県,4405,南部,はい,697,718,676,685,693,893,1054,5416,509,553,581,569,734,952,1264,5162
大分県,4405,南部,いいえ,242,362,300,305,292,242,270,2013,257,304,353,329,331,330,387,2291
大分県,4406,豊肥,はい,483,548,533,515,761,789,971,4600,422,448,465,486,712,817,1042,4392
大分県,4406,豊肥,いいえ,209,216,218,219,247,220,307,1636,226,263,248,255,326,328,347,1993
大分県,4408,西部,はい,913,1099,989,1028,1131,1084,1167,7411,707,831,793,804,915,980,1201,6231
大分県,4408,西部,いいえ,392,435,406,415,425,349,311,2733,349,400,436,463,448,382,443,2921
大分県,4409,北部,はい,1882,2066,1847,1713,1693,1616,1883,12700,1222,1324,1310,1189,1407,1692,2105,10249
大分県,4409,北部,いいえ,1022,1076,964,850,706,531,460,5609,622,824,858,790,727,610,687,5118
宮崎県,4501,宮崎東諸県,はい,5367,6242,5360,4718,4454,3886,3955,33982,3901,4694,4065,3510,3324,3526,4232,27252
宮崎県,4501,宮崎東諸県,いいえ,2316,2797,2623,2192,1708,1119,972,13727,2125,2651,2584,2198,1644,1157,1316,13675
宮崎県,4502,都城北諸県,はい,2036,2172,1808,1741,2165,2202,2851,14975,1477,1624,1521,1489,1855,2469,3312,13747
宮崎県,4502,都城北諸県,いいえ,987,1008,887,787,694,501,505,5369,780,901,870,832,808,745,843,5779
宮崎県,4503,延岡西臼杵,はい,1811,2112,1948,1785,1771,1715,2234,13376,1147,1375,1211,1228,1389,1757,2266,10373
宮崎県,4503,延岡西臼杵,いいえ,871,1023,995,870,674,479,463,5375,658,841,910,779,674,577,735,5174
宮崎県,4504,日南串間,はい,543,580,540,540,677,767,880,4527,397,392,359,444,564,749,980,3885
宮崎県,4504,日南串間,いいえ,258,281,297,293,276,179,180,1764,185,253,291,315,255,244,332,1875
宮崎県,4505,西諸,はい,631,655,584,625,808,958,1247,5508,460,473,418,567,693,979,1280,4870
宮崎県,4505,西諸,いいえ,270,232,218,282,259,200,225,1686,254,261,281,310,321,290,332,2049
宮崎県,4506,西都児湯,はい,882,996,845,841,952,1154,1356,7026,685,787,721,702,807,1137,1489,6328
宮崎県,4506,西都児湯,いいえ,386,431,389,394,355,346,312,2613,373,496,471,461,477,431,476,3185
宮崎県,4507,日向入郷,はい,900,959,805,817,798,922,1088,6289,660,730,689,604,699,826,1161,5369
宮崎県,4507,日向入郷,いいえ,372,479,370,355,306,249,259,2390,355,374,423,375,330,325,418,2600
鹿児島県,4601,鹿児島,はい,7405,8418,7360,6881,7177,6930,8132,52303,5635,6029,5357,4891,5414,6615,8593,42534
鹿児島県,4601,鹿児島,いいえ,3285,3850,3483,3044,2500,1810,1561,19533,2816,3498,3666,3120,2517,2169,2443,20229
鹿児島県,4603,南薩,はい,1043,1072,1070,1205,1504,1944,2386,10224,741,814,837,1000,1341,1984,2625,9342
鹿児島県,4603,南薩,いいえ,418,472,493,484,481,486,477,3311,351,420,456,468,554,617,654,3520
鹿児島県,4605,川薩,はい,1194,1336,1187,1399,1500,1676,2130,10422,903,969,958,1007,1191,1666,2186,8880
鹿児島県,4605,川薩,いいえ,613,629,608,603,528,461,528,3970,466,539,633,629,645,613,665,4190
鹿児島県,4606,出水,はい,792,852,832,860,873,995,1240,6444,597,663,642,652,778,1086,1259,5677
鹿児島県,4606,出水,いいえ,347,345,371,353,306,275,247,2244,312,371,417,428,374,370,402,2674
鹿児島県,4607,姶良・伊佐,はい,2584,2840,2695,2712,2814,2803,3563,20011,1930,2115,2088,2020,2220,2800,3756,16929
鹿児島県,4607,姶良・伊佐,いいえ,1137,1290,1256,1201,1019,722,761,7386,928,1145,1220,1223,1149,934,1153,7752
鹿児島県,4609,曽於,はい,661,664,668,745,918,955,1127,5738,442,471,488,604,715,906,1098,4724
鹿児島県,4609,曽於,いいえ,285,273,299,287,306,236,214,1900,247,244,281,293,372,310,317,2064
鹿児島県,4610,肝属,はい,1456,1494,1388,1436,1685,1799,2090,11348,1013,1093,1071,1133,1453,1795,2177,9735
鹿児島県,4610,肝属,いいえ,688,610,582,588,581,487,442,3978,501,607,674,655,644,587,652,4320
鹿児島県,4611,熊毛,はい,384,459,448,433,485,497,532,3238,285,282,318,270,329,460,514,2458
鹿児島県,4611,熊毛,いいえ,142,162,174,184,138,142,139,1081,112,140,145,146,174,194,237,1148
鹿児島県,4612,奄美,はい,962,1045,1010,1044,1127,1329,1367,7884,837,805,774,803,1024,1395,1461,7099
鹿児島県,4612,奄美,いいえ,345,423,382,417,377,401,363,2708,341,452,407,394,429,447,501,2971
沖縄県,4701,北部,はい,1088,1165,912,921,1053,1180,1151,7470,880,883,688,740,972,992,1047,6202
沖縄県,4701,北部,いいえ,431,491,406,365,416,402,393,2904,382,431,373,448,385,414,371,2804
沖縄県,4702,中部,はい,4644,5560,4793,3922,3260,2529,2259,26967,3810,4569,3965,3263,2765,2461,2359,23192
沖縄県,4702,中部,いいえ,2286,2830,2505,2042,1497,1056,812,13028,2375,2871,2624,2039,1549,1105,955,13518
沖縄県,4703,南部,はい,6743,7767,6938,5728,4913,4466,4458,41013,5694,6367,5698,4888,4492,4671,4860,36670
沖縄県,4703,南部,いいえ,3952,4712,4263,3497,2704,1912,1634,22674,4092,4736,4760,3847,2797,2230,2111,24573
沖縄県,4704,宮古,はい,489,559,468,530,540,574,484,3644,406,431,345,424,542,551,512,3211
沖縄県,4704,宮古,いいえ,226,250,200,211,217,206,142,1452,247,223,216,213,215,193,176,1483
沖縄県,4705,八重山,はい,297,336,307,229,280,327,335,2111,266,282,213,207,260,314,352,1894
沖縄県,4705,八重山,いいえ,120,144,134,107,99,95,101,800,139,139,128,125,112,125,133,901
二次医療圏判別不可,,,はい,54129,56120,54613,49849,26809,8276,5147,254943,27624,30374,27794,21429,12118,5516,3479,128334
二次医療圏判別不可,,,いいえ,21976,26448,27938,24873,11125,2238,1078,115676,13119,17060,18064,13717,6343,1968,1000,71271
